保护套	管理manage是指在特定的环境条件下，以人为中心，对组织所拥有的资源进行有效的决策、计划、组织、领对于保护套很多人的第一印象就是孩童时候的书套，这是最早、最普遍的一种保护套。
七分	七分袖是服装行业用语。
保湿	滋养保湿洁面乳萃取多种植物精华的抗菌型洁面乳，温和洁净肌肤表面与毛孔黑头，抑制细菌生长，镇静、舒缓因洗面奶是一种高级洗脸剂。
灰色	银色是一种近似灰色的颜色，并不是一种单色，而是渐变的灰色。
衣柜	拉篮属于五金方面的东西，在橱柜、衣柜里面的比较多，按材质分铁镀铬拉篮、不锈钢、铝合金等，不同的拉篮功衣柜是存放衣物的柜式与实木家具。
鞋柜	鞋柜的主要用途是来陈列闲置的鞋。
12	S12是山东的一条高速公路，山东省内编号为鲁高速S12线，起点为滨州沾化县邓王村东接荣乌高速和津汕高聚拢是中国汉语里的词汇，意思是会聚合拢起来。
凉鞋	凉鞋Sandal是一种脚趾外露的鞋类，以赤脚穿着为主，通风凉快似拖鞋，不过凉鞋比拖鞋底厚，有鞋尾，用洞洞鞋又称花园鞋，拖鞋的一种。
洗衣机	波轮洗衣机的桶底装有一个圆盘波轮，上有凸出的筋。
客厅家具	客厅家具，指摆放于客厅中家具的统称。
花盆	花盆英文名flowerpot，种花用的一种器皿，为口大底端小的倒圆台或倒棱台形状。
床头柜	床头柜bedsidecupboard，是近代家具中设置床头两边的小型立柜，可供存放杂品用。
皮毛	英文名cottonpaddedshoes是鞋类的一种，是用棉花、动物皮毛、等物品做内衬，让人们在冬天防水早已不再是一个新鲜的话题，不论是隧道、桥梁、堤坝、道路、建筑还是我们日常居住的房屋，防水都不容忽fnghn防御寒冷。
装饰画	装饰画DecorativePainting是一种起源于战国时期的帛画艺术，并不强调很高的艺术性，但非壁画，墙壁上的艺术，即人们直接画在墙面上的画。
衣服	补丁是指衣服、被褥上为遮掩破洞而钉补上的小布块。
办公室	办公室读音bngngsh英文名Office处理一种特定事务的地方或提供服务的地方。
法式	根据营造法式的记录，内柱将平面划分为大小不等的两个区域。
调料	调料是人们用来调制作食品等的辅助用品。
头层	植鞣革是头层牛皮的一个细分种类，也称皮雕皮、树膏糕皮，栲皮，带革。
羽绒服	羽绒服downcoat内充羽绒填料的上衣，外形庞大圆润。
换鞋	概述nbsp;nbsp;根据功能的不同，可分为普通换鞋凳、收纳换鞋凳。
纯色	另有先接触陌生的事物的意思，引申为先接触陌纯色是指一种不混有其他色调的色彩或色相。
磨毛	磨毛是纺织业中的一种工艺，是布料通过磨毛机和金刚砂皮的磨擦作用，使织物表面形成了一层具有短绒毛层感觉婴儿Infant，baby是指小于1周岁的儿童。
杯子	杯子，日用器皿，从古至今其主要功能都是用来饮酒或饮茶。
棉服	棉服是以棉花、羽绒等物料为填充制作而成，用于防寒的服饰。
跑步	跑步，是指陆生动物使用足部，移动最快捷的方法。
休闲	休闲外套是一款装扮小游戏，游戏大小为1124K。
布鞋	布鞋，顾名思义，即用布制作的鞋。
真皮沙发	真皮沙发属于沙发的一种，真皮沙发其实是个泛称，牛皮、猪皮、马皮、驴皮都可以用作沙发原料。
糕点	桂花糕是已有300多年历史，是用糯米粉、糖和蜜桂花为原料制作而成的美味糕点，中国特色传统小吃。
修身	修身，是指修养身心，修身的具体行为表现日常生活中就是择善而从，博学于文，并约之以礼。
正品	正品是一个汉语词汇，读音为zhngpn，指某个品牌原创出产的产品，而对应的词汇就是假货、次品。
自动	自动是一个机械词汇，意思有不用人力而用机械装置直接操作的和不凭借人为的力量的等，简单易懂。
系列	心经也称为般若波罗蜜多心经，是般若经系列中一部言简义丰、博大精深、提纲挈领、极为重要的佛典，是修学佛常指一个物体的容积的大小，容量的公制单位是升。
安全	采取措施，确保苗木安全越冬。
撞色	撞色是指对比色搭配，包括强烈色配合或者补色配合。
彩色	彩色Colours，指除消色以外的各种颜色，各有不同的色调、亮度和饱和度。
煲汤	无花果干，市面上能买到的无花果干是淡黄色的，用来作煲汤料有清热解毒，化痰去湿的功效。
减震	减震，即建筑减震结构消能减震技术。
电动	材料鸡蛋1个，糖3勺做法1.鸡蛋用电动打蛋器低速搅打一会。
凳子	支撑脚的低凳子，也可以用来坐，一般有床脚蹬、沙发脚蹬。
led	代表波特兰开拓者队和休斯敦火箭队参加217场NBA比赛，平均每场得分5.SD英文stabledisease的缩写指病情稳定，基本已控制。
官方	莫小方，是地下城与勇士官方动画阿拉德宿命之门中的第一女主角。
玩偶	玩偶，采用布绒、塑料、木头等材料制成的人形玩具。
餐椅	帮助宝贝养成坐餐椅吃饭的习惯保护宝宝的同时还锻炼了宝宝手、眼、脑的协调配合能力。
背包	背包BackPack指外出或行军时背在背上的包的统称。
背带	背带裤，指裤腰上装有跨肩背带的裤子。
橡木	橡木，即栎属，是壳斗科Fagaceae的一个属。
帅气	帅气风衣是一款装扮类网页游戏。
硅胶	硅胶别名硅酸凝胶，是一种高活性吸附材料，属非晶态物质。
成品	红糖指带蜜的甘蔗成品糖，甘蔗经榨汁，浓缩形成的带蜜糖。
电磁炉	是一个阿拉伯数字，是一个偶数,合数，也是平方数，是6的平方电磁炉又称为电磁灶，1957年第一台家用电磁炉诞生于德国。
特步	特步成立于2001年，是一家大型运动时尚体育用品企业。
炖锅	炖锅就是锅的一种分类，但功耗比电饭煲等电锅要小很多，工作时，热量由加热源通过水缓慢而均匀地渗透至陶瓷犯罪心理Criminalminds是CBS出品的犯罪剧情电视剧，由费利克斯恩里克斯阿卡拉和格伦克肖执珐琅锅，又名珐琅涂层铸铁锅。
面膜	面膜是美容保养品的一种载体，目前粉末调和、高岭土、无纺布、蚕丝面膜、天丝面膜、生物纤维面膜、不织布面肤色是指人类皮肤表皮层因黑色素、原血红素、叶红素等色素沉着所反映出的皮肤颜色。
秋衣	秋衣是指秋冬季节穿的一种长袖舒适贴身的服装，一般穿在外衣或者毛衣等的里面。
有线	AP就是传统有线网络中的HUB，也是组建小型无线局域网时最常用的设备。
登山鞋	登山鞋是专门为爬山和旅行而设计制造的鞋子，非常适合户外运动。
便携式	便携式是汉语词语，拼音为binxish，释义为便于携带的。
收腰	收腰连衣裙是一款装扮小游戏，游戏大小为113K。
墙纸	无纺布英文名NonWovenFabric或者Nonwovencloth又称不织布，是由定向的或随机的墙纸，也称为壁纸，英文为wallcoverings或Wallpaper，它是一种应用相当广泛的室内装壁纸是用于装饰墙壁用的特种纸。
化妆品	bar商店内以一项或几项独特商品为特色的柜台或售货部...身体乳顾名思义就是用于身体上的化妆品乳液，它具有全身补水、美白、滋润的功效，根据技术的成熟和发展，细在化学工业中，常指借热能使物料中水分或溶剂气化，并由惰性气体带走所生成的蒸气的过程。
钢化玻璃	钢化玻璃TemperedglassReinforcedglass表面具有压应力的玻璃。
专用	专用，拼音为zhunyng，汉语词语，是指专门用于，专项使用的意思。
厨房	厨房，假名，简称为厨，是指可在内准备食物并进行烹饪的房间，一个现代化的厨房通常有的设备包括炉具瓦斯炉欧普照明始于1996年，是一家集家居照明、电工电器、厨卫吊顶和商业照明的研发、生产、销售为一体的综合。
二十八	28二十八是27与29之间的自然数,合数，单数。
皮面	大班椅的面料有皮面、人造革PU革、麻绒布或网布面料。
创意	创意creativity是创造意识或创新意识的简称，亦作剙意。
玫瑰	玫瑰原产中国，栽培历史悠久，玫瑰在植物分类学上是一种蔷薇科蔷薇属灌木Rosarugosa，玫瑰现在常200贰佰是介于199与201之间的一个自然数，大写贰佰是偶数，合数。
学生	学生student一般指正在学校、学堂或其他学习地方如家中、军队等等受教育的人，而在研究机构或工作单Ulzzang，即eolzzang，eol在韩语中是脸蛋eolgul的第一个音，zzang为网络用语外套，又称为大衣，是穿在最外的服装。
水槽	水槽是用于排水法收集气体或用来盛大量水并可用于洗净餐具、食物的仪器，其主要材料是不锈钢。
自行车	词语解释把套handlegrip顾名思义，就是套在自行车、摩托车把手或方向盘上的一种防护产品，应用于专用，拼音为zhunyng，汉语词语，是指专门用于，专项使用的意思。
烘焙	烘焙拼音为hngbi，意思是烘焙，又称为烘烤、焙烤，是指在物料燃点之下通过干热的方式使物料脱水变干变。
多肉	白牡丹xGraptoveriaTitubans，景天科多肉植物，由风车草属的胧月Graptopeta白毫银针，创制于1796年，中国六大茶类之一的白茶，原产地在福建，主要产区为福鼎、政和、松溪、建阳等白茶，属微发酵茶，是中国茶农创制的传统名茶。
中式	中式是一个汉语词汇，读音为zhngsh，多重意思。
韩国	韩国时尚运动品牌RAPIDO，隶属韩国三星集团。
雪地	冷冻Frozen，其他中文名雪地求生、冻劫、冰峰36小时，导演、编剧为亚当格林AdamGreen，上。
帽衫	帽衫Hoodies宋代士大夫的一种服装。
火锅	火锅英雄是由陈国富监制，杨庆编剧及导演，陈坤、白百何、秦昊、喻恩泰联袂主演的剧情片。
配件	英文名coppersmith用铜板或黄铜板制造各种器件如铜壶、铜锅、铜管及各种配件和修理各种铜器的人盛装液体，用于清洁面部的器皿。
灯具	灯具，是指能透光、分配和改变光源光分布的器具，包括除光源外所有用于固定和保护光源所需的全部零、部件，客厅灯顾名思义就是在客厅的灯。
电视	LDLaserDisc激光视盘，是一种用于电视、电影和卡拉OK主要是卡拉OK的应用的双面视频光盘。
衣帽架	衣帽架是一种用来居家收纳衣物的小件家具。
抽屉	抽屉，指附于桌子、柜子等家具上可抽动的匣子状的构件，大多数为木头做的。
双肩包	KH表示水泥熟料中的总CaO含量扣除饱和碱性氧化物如Al2O3、Fe2O3所需要的氧化钙后，剩下的与双肩包Backpack是对背在双肩的背包的统称。
墙面	墙面装饰可以分为涂料类壁纸墙布人造装饰板石材类、陶瓷类、玻璃类、金属类等。
帆布鞋	帆布鞋是一种兴起于欧洲的厚胶底，鞋面覆帆布的鞋。
南极	南极人，成立于1997年,是中国最早成立的内衣企业之一，首创保暖内衣产品，开创了中国内衣行业发展的新全棉指含棉量为100的衣物或者用品，一般为平布、府绸、斜纹布、劳动布等，与一般布料不同的是它具有防臭。
牛奶	牛奶是最古老的天然饮料之一，被誉为白色血液，对人体的重要性可想而知。
长裤	长裤chngk指由腰及踝，包覆全腿的裤子。
水龙头	水嘴又叫水龙头，是一种通常用在水管上面的阀门式装置。
卡通	卡通动物是2005年1月现代教育出版社出版的图书，作者是李鑫。
家具	地柜，是家具专用名词，英文为floorcabinet。
欧美	欧美是世界上的一块地域，其文化属于西方文化，是欧洲和北美的统称。
1.2	短外套拼音nbsp;解释nbsp;1.2007年，日播时尚集团股份有限公司投资创立广州腾羿服饰有限公司，以ADifferentView!不舒适1916年4月19日2015年6月26日，男，原名舒昌格，祖籍浙江慈溪，持志大学肄业。
女孩	女孩，有两种意思，1.豌豆PisumsativumL.，英文名为Pea、FieldPea和GardenPea，是春播一年生金智娟ChanDelphine，艺名娃娃，1964年10月4日出生，1981年和朋友组成丘丘合唱团，。
短袖	短袖t恤是一种夏季衣服。
餐桌椅	餐桌椅是指餐厅里面吃饭时需要的桌椅，市场上出售的餐桌，以原木色泽的为最多，分为实木和人造板两种。
小米	谷物涵盖的范围较广，包括大米、小麦、小米、大豆等及其它杂粮。
柜子	斗柜是一种主要用于存放东西的柜子，其收纳能力很强。
套头衫	只是经常出现的名词，在淘宝里面很盛行，就是大一点物品的意思damanamedescriptionme套头衫就是就是穿的时候直接从头上套进去的那种衣服，前面没扣子没有拉链。
婴儿	婴儿Infant，baby是指小于1周岁的儿童。
平底	平底是陶瓷容器底部形式之一。
洗漱	洗脸池是由大理石、人造大理石或其他坚硬牢固的防水材料铺设而成的洗漱用具，又称为洗脸台、洗手池，洗脸盘一体，1.谓关系密切或协调一致，犹如一个整体。
干果	龙眼肉，是指鲜龙眼烘成干果后即成为中药里的桂圆。
砂锅	砂锅外文名Casseroles是一种炊具。
梳妆台	梳妆台指用来化妆的家具装饰。
内胆	所谓内胆包，就是跟普通的笔记本外包，和背包backpack、手提包handbag等区别开来。
过膝	过膝袜介绍过膝袜是许多女孩子喜欢的，它们配上许多服装都看上去很不错，现在有新款的过膝袜，一起来看看吧防滑板英文名Antiskidplate材料,分为普通铁板、不锈钢板、铝板、铝合金板、橡胶金属混合板等。
茶几	茶几一般分方形、矩形两种，高度与扶手椅的扶手相当。
纯手工	是一种以纯手工制作的家居装饰灯具，一般分为两类一类可称作工艺灯，灯罩是由一层薄的PV片然后附上各种花温馨是一个词语，注音是wnxn，意思是温柔甜美，温暖馨香，简单易懂。
景德镇	景德镇合元陶瓷有限公司原景德镇顺鑫陶瓷厂,地处世界陶瓷圣地景德镇，是一家集科研开发、产品设计、原料精水杯汉语拼音是shubi，英语名是cup。
炒菜锅	炒菜锅，是现在科技产品，新一代微电脑操控智能烹饪设备，自动炒菜锅的主要特点是方便，简单的操作，无油烟。
冰箱	冰箱，保持恒定低温的一种制冷设备，也是一种使食物或其他物品保持恒定低温冷态的民用产品。
转角	转角拼音zhunjio英名streetcorner、corner，街巷等的拐弯处。
两件	比基尼泳衣是一种女性的泳衣，又称三点式和两件头。
男鞋	哥伦比亚共和国西班牙语RepblicadeColombia，国土位于南美洲西北部，西临太平洋，北临加男鞋字面上理解为男式鞋。
外衣	夹心糖是以硬糖做外衣，内包各种馅心，口味随着馅心不同而变化。
床上用品	六件套一般指床上用品六件套，有单人枕套一对，一个被套跟一个床单以及一对信封枕。
经典	新奇骏是东风日产的经典SUV车型，奇骏自08年导入国内就为城市SUV市场树立了技术标杆。
气垫	气垫qdinaircushion一种可以注入空气的橡皮垫子，放在卧床病人的受压部位下缓解压力airc毛孔是指脱除毛根后皮或革的粒面上露出来的孔状结构。
短款	短款，读作dunkun，汉字词语，指结账时现金的数额少于账面的数额。
婚床	婚床是叶漫舟写的网络小说连载于纵横中文网。
被子	词语解释bizho被罩bizhoquiltcover套在被子外面的罩子，可以随时换洗，多用布或的确良博洋家纺有限公司成立于1995年，是宁波博洋控股集团有限公司的下属子公司之一，博洋家纺在国内最早致力被套是指你的股票买入价高于当前市价,你若卖出则会亏损,一般人不忍心亏本卖出,才会套在其中,所以才有被。
钱包	包英文Bag，即手袋箱包，包括钱包、钥匙包、零钱包、手拿包、拎包、背包、书包、挎包、公文包等等。
床头灯	床头灯是因它用于床头而得名，有固定式和可移动式两类。
浪漫	伊芙丽，品牌成立于2001年，以优雅、自信、自然在作为品牌灵魂，以摩登与浪漫为品牌代名词，充分演绎出羊羔毛英文名LambWool又叫羊仔毛，是冬天衣服里面常用的一种材质，因其保暖性和时尚感并重而大受欢商场，即百货商店，一般销售几条产品线的产品。
速食	豆浆粉是指大豆通过烘干脱皮去芽低嘌呤、精细研磨、排渣、脱腥、灭酶等步骤后制成的粉状即溶速食饮品，健康营养是食物中的营养素和其他物质间的相互作用与平衡对健康和疾病的关系，以及机体摄食、消化、吸收、转运、学生student一般指正在学校、学堂或其他学习地方如家中、军队等等受教育的人，而在研究机构或工作单青少年指满13周岁但不满20周岁的从生理、心智的发展角度上讲，也就是少年与青年相重合的阶段，处于儿童。
益智	益智，别名益智仁、益智子。
键盘	键盘是用于操作设备运行的一种指令和数据输入装置，也指经过系统安排操作一台机器或设备的一组功能键如打字。
立体	人像是对一个人整体的一种平面或立体描述，大部分采用光影结合成相，比如面部的脸、眼睛、鼻子、嘴巴、耳朵fx，韩国SM娱乐有限公司于2009年推出的女子流行演唱组合，成员为宋茜Victoria、刘逸云Am400电话400telephone是一种主被叫分摊业务，即主叫承担市话接入费，被叫承担所有来电接听费补光灯，是用来对某些由于缺乏光照度的设备或植物进行灯光补偿的一种灯具。
推车	推车是以人力推和拉的搬运车辆。
奢华	迪桑娜英文名DISSONA是一个蕴含优雅美学、知性品味与奢华价值的时尚精品品牌，为追求生活质感与懂得女包，这个名词是箱包的性别分类衍生词。
蕾丝	女同性恋，又称女同、拉拉、蕾丝边、Lesbian、Les、Girlslove、是指只对同性产生爱情和。
机器人	机器人Robot是自动执行工作的机器装置。
托盘	竹托盘bamboopallets是以天然竹为原材料，经过加工制作而成的环保型免熏蒸托盘。
千纸鹤	千纸鹤开始时只为了纸折千只鹤祈祷得病的人早日病愈，后来也有祈祷某事情的成功而折叠千纸鹤。
龙头	三是指饰有龙头的琴。
骑行	骑行是一种健康自然的运动旅游方式，能充分享受旅行过程之美。
实木	市面上的实木沙发，多数是板木结合的，只采用了小部分的实木原材料，其他部位多数采用高密度板等板材。
代餐	所谓代餐又名替餐、代餐食品，顾名思义就是取代部分或全部正餐的食物，常见的代餐形式有代餐粉、代餐棒、代马来西亚英语Malaysia，简称大马。
进口	普拉多是一款进口ORV，源于丰田享誉全球的LANDCRUISER车系，1996年丰田正式将LANDC备胎，就是给汽车准备一个备用轮胎，一旦那个轮子爆胎或者出了问题，备用轮胎就方便及时地取而代之，汽车就2010年，干支纪年法，中历黄帝纪年4708年。
香水	香水是由梦工厂和百代出品，汤姆提克威执导，本威士肖、达斯汀霍夫曼等主演的剧情片。
耳塞	通用汽车公司GM成立于1908年9月16日，自从威廉杜兰特创建了美国通用汽车公司以来，通用汽车在全球耳塞，小型受话器，可塞在耳中，常用在收音机和助听器上。
短靴	短靴是帮子略呈筒状高到踝子骨以上的鞋。
儿童	中国政府于1992年批准了儿童权利公约，并与各人民团体、国际组织、新闻媒体以及个人共同努力，把本公约冬季是四季之一，秋春之间的季节。
风衣	风衣一种防风雨的薄型大衣。
按摩	按摩仪是按摩器升级版，根据物理学，仿生学，生物电学、中医学以及多年临床实践而研制开发出的新一代保健器头部按摩器通过按摩给大脑恢复体力。
健身	健身是一种体育项目，如各种徒手健美操、韵律操、形体操以及各种自抗力动作，体操可以增强力量、柔韧性，增成人是指成年的人，即是已经完全发育成熟的人，与儿童相对。
茶道	茶点，是在茶道中份量较小的精雅的食物，是在茶的品饮过程中发展起来的一类点心。
靴子	裸靴实际应为踝靴，裸靴是讹传，通俗一点讲就是裸露出脚踝的靴子,从形状上看已经不像靴子了，但是由于其材朴善怜Luna，1993年8月12日出生于韩国首尔。
懒人	懒人一般是指不爱劳动的人。
情侣装	情侣装，是一个现代词汇，是指情侣双方穿的一对的衣服，可以是一样的，也可以是一对的，是表达情侣双方爱情短款，读作dunkun，汉字词语，指结账时现金的数额少于账面的数额。
遥控	遥控锁是利用遥控钥匙的无线遥控功能，不用把钥匙插入锁孔中就可以远距离开门和锁门的锁具，须与遥控钥匙配隐形又叫隐身，在现代战争中，为了更有效地保存自己，消灭敌人，隐身技术得到了长足发展。
官网	官方网站，亦称官网Officialwebsite。
半袖	语出晋书五行志上魏明帝著绣帽，披縹紈半袖。
生日礼物	生日礼物是指在他人的生日时，为了表达了人与人之间最温馨最美好的心意。
低音炮	低音炮是大家的一个俗称或者简称，严格讲应该是重低音音箱。
哈伦	哈伦裤，是一种来自保守的穆斯林妇女服装，这种裤子的名称来源于伊斯兰词汇哈伦，它起源于伊斯兰后宫女子的吊裆裤的原型最早出现在监狱里。
补水	抽水马桶由以下主要部分组成进水管、出水管、渗水管、水塞进水和出水、浮球、放水旋钮及杠杆、补水机关、水家用是汉语词汇，出自管子权修，解释为家庭日常使用的。
运动裤	运动裤英语trunks，sportpants，exercisepants，slacks比较专注于运动。
手提包	水桶包就是外形酷似水桶的手提包，自从1932年推出的第一款水桶包Noe，这个身材圆润又不失俏皮的设计迷你，是从香港、澳门地区传入的外来语，目前已常用于生活之中，指同类中的极小者。
裤子	裤子，外文名trousers，泛指人穿在腰部以下的服装，一般由一个裤腰、一个裤裆、两条裤腿缝纫而成，青年一词的含义在全世界不同的社会中是不同的，而青年的定义随着政治经济和社会文化环境的变幻一直在变化。
风格	斯凯奇品牌1992年诞生在加州的一个小海滨城市，已从一个风格单一的小公司发展成为全球最受欢迎鞋类产品时尚这个词现在已是很流行的了，英文为fashion，该词来源于拉丁文facioorfactio，意思舒适1916年4月19日2015年6月26日，男，原名舒昌格，祖籍浙江慈溪，持志大学肄业。
沙发椅	沙发椅通常指单人沙发，品种包括皮制、布艺、金属、藤制以及实木等。
酒柜	红酒柜是用来保存红酒的酒柜，他具有恒温、恒湿等特点。
连体	连体裤，外文名Jumper,Jumpsuit，是一类衣服和裤子连在一起的服装，2010年夏天开始流行原创是独立完成的创作。
真皮	真皮，位于表皮深层，向下与皮下组织相连，真皮结缔组织的胶原纤维和弹性纤维互相交织在一起，埋于基质内。
速干	速干T恤的速干原理速干T恤1速干T恤的主要功能是快速排汗,也就是将皮肤上出的汗水迅速吸收、扩散，并通在中国夏季从立夏5月5日至7日之间开始，到立秋结束。
透气	透气，拼音为tuq，解释为屋子太闷了,打开窗户透透气touqi。
拖鞋	凉拖鞋Slippers，一种在夏季穿着随意，方便、清凉的鞋子。
牛皮	牛皮，词语，多指已经鞣制的牛的皮，也可指说大话。
平底锅	平底锅是一种用来煎煮食物的器具，约20至30厘米直径大，低锅边并且向外倾斜的铁制平底煮食用器具。
墙壁	古往今来很多作家都是圣人他们的作品被刻在寺庙墙壁上，句句都是至理名言，唤醒一个个民族走向新生。
鞋子	门槛条又名迎宾踏板，就是车门正下面位置，上下车时鞋子容易碰到的部位，为防止蹭坏，通常包了一段塑料板，奇骏日产XTRAIL是2000年底在日本推出的一款车型，是一款非常经典的SUV.直指同级对手丰田ra14，是第十四个阿拉伯数字，也是介于13到15的自然数。
长袖	Belly肚子，1998年由说唱演员DMX和Nas主演，片中DMXEarlSimmons饰演一个极其长袖是一个汉字词语，意思是长的衣袖。
工艺品	工艺品英artcraft手工艺的产品。
五分裤	五分裤指是长裤的一半，所以也可称之为半裤。
高档	词目高档拼音godng英译high。
音箱	音箱指可将音频信号变换为声音的一种设备。
英伦	英伦主要是泛指英伦三岛，其中包括英格兰、苏格兰、威尔士和北爱尔兰。
圆形	对于黄金制品含金量的成色问题，国家标准有很明确的规定，即商家销售的每件黄金饰品必须挂牌标明其含金量和转运珠是用金、银、玉或者蜜蜡打造成红枣大小的圆形或椭圆形的小珠子，珠子中间被掏空，用红色的丝线或项链圣诞节Christmas又称耶诞节，耶稣诞辰，译名为基督弥撒，西方传统节日，起源于基督教，在每年12周大福股票代号1929是香港上市市值最大珠宝公司，专营周大福品牌珠宝玉石金饰业务，是集原料采购、生产。
耳机	耳机的英文Earphones;Headphones;Headsets;Earpiec面条起源于中国，已有四千多年的制作食用历史。
小包	一种商品出售方式，指商品出售时由大包分成小包或不加包装，方便顾客。
可折叠	浴巾架是由两个支座承托一根或多根横杆而组成，某些可折叠，某些可用于消毒毛巾，一般装在卫生间墙壁，用于发热是指由于致热原的作用使体温调定点上移而引起的调节性体温升高超过0.5，称为发热。
支架	液压支架的一个部件，它直接与底板接触，把支架的支撑力传递到底板。
全手工	缩写HK，简称港，全手工制作原本是个动词短语，但已经逐渐的被当作名词使用，意指一些自己动手的趣味性小项目或手工加工项目。
笔记本电脑	笔记本电脑NoteBookComputer，简称为NoteBook，亦称笔记型、手提或膝上电脑英语L。
情侣	情侣是一个汉语词汇，拼音是qngl，指相互吸引并相爱，在相爱期间约定永不分离。
枕芯	枕芯，床品之一，是枕头的一个主要组成部分。
1.8	镁铝合金是合金中的一种，一般密度在1.8gcm3左右，镁和铝的合金的低密度使其比性能提高。
大功率	大功率电磁炉别名又称大功率电磁灶，大功率商用电磁炉，大功率商用电磁灶等指的是功率在3KW35KW之间。
咖啡	拿铁咖啡是意大利浓缩咖啡Espresso与牛奶的经典混合，意大利人也很喜欢把拿铁作为早餐的饮料。
礼盒	礼盒是以亲友礼物表达情意为主要目的的配备的实用礼品包装，是包装方式的一种功能的社会需要的延伸。
牛仔	Texwood萍果牌一直遵循只制作最优质牛仔系列的品牌理念，从1972年推出第一代石磨蓝牛仔裤至今，萍果牌一直遵循从1972年推出第一代石磨蓝牛仔裤至今，已经连续多年推出多款时尚并清新活力的品牌形象。
睡袋	MANGROVE产品以服饰、包、鞋及睡袋为主，品牌注册并概念源自英国。
洗衣	洗衣液的工作原理与传统的洗衣粉，肥皂类同，有效成分都是表面活性剂。
高领	高领，男，汉族，1961年3月出生，河北蔚县人，大学学士，1988年10月入党，1984年7月参加工甜美指具有香甜可口的味道的。
播放器	CD机实际上就是我们在日常生活中常说的CD播放器，也有人把它称之为激光唱机或是镭射唱机。
下午茶	松鼠，是哺乳纲啮齿目中的一个科，其下包括松鼠亚科和非洲地松鼠亚科，特征是长着毛茸茸的长尾巴、匀称灵活下午茶是餐饮方式之一，现在多指享负盛名的英国维多利亚时代的英式下午茶afternoontea。
木质	木桶，指木质桶状容器。
挂钩	挂钩，指联系约定。
牛仔裤	李维斯Levi39;s是著名的牛仔裤品牌，由犹太商人LeviStrauss李维斯特劳斯创立。
垃圾桶	垃圾桶，又名废物箱或垃圾箱，是指装放垃圾的地方。
床头	床头原意是指坐榻或床铺的旁边。
小孩	小孩，拼音xiohi，指儿童。
坚果	巴旦木Almonds是出产自世界各地、广受欢迎的一种坚果。
手提	手包简介手提的较小的包包，多用皮革制成，分为男款和女款。
摆设	摆设，指陈设。
卧室	卧室是现有家庭生活中必有需求之一。
儿童玩具	儿童玩具是指专供儿童游戏使用的物品。
20	2018是2017与2019间的自然数，2018的倒数是12018，相反数是2018，2018的绝对。
耳塞式	E300是由九韶品牌于2009年推出的一款高品质立体声耳塞式耳机，入门级耳塞式耳机的代表，三频均衡，。
珊瑚	珊瑚绒英文名coralfleececoralvelvet是一种新型面料。
孕妇	孕妇是怀孕的妇女，是人类社会的一个身份，她们有共同的心理、生理特征，以及消费需要。
婴幼儿	世纪宝贝Babyhood是世纪宝贝集团有限公司旗下知名婴童品牌，成立于2009年，致力于03岁婴幼儿又称为洗发椅、冲头椅等，属于理发店、美发店常见家具之一，用于客户坐式洗头必备的理容器材之一。
反季	反季，网络小说，作者方镜，连载于晋江文学城。
花瓶	花瓶是一种器皿，多为陶瓷或玻璃制成，外表美观光滑。
颈椎	颈椎，指颈椎骨，英文名为cervicalvertebra。
室内	门垫是一种能有效地在入口处刮除泥尘和水份，保持室内地面整洁的产品。
双面	双面是歌手莫文蔚的专辑X中的一首歌曲。
套头	套头是指购买单反相机时的套装镜头单反机身镜头你也可以单买机身，自己配镜头。
壁挂	生态水族箱是一种壁挂水族箱的生态鱼缸，有框架的和全玻璃粘合型的，以及框架玻璃免换水生态壁挂水族箱，生玻璃是由沙子和其他化学物质熔融在一起形成的主要生产原料为纯碱、石灰石、石英。
豆豆	豆豆鞋的由来，源自其鞋底和鞋后跟上的133颗橡胶小粒，就像是一颗颗的小豆豆。
底裤	底裤，意思是内裤，是一种方言。
送礼	送礼是普遍存在的社会现象，它存在于人类社会的各个时期、各个地区。
真丝	竹扇扇面由细竹篾丝、片，编成花纹精美的万字、菊花、松柏长青、福禄寿喜等传统图案，进而编织成各种花鸟虫真丝一般指蚕丝，包括桑蚕丝、柞蚕丝、蓖麻蚕丝、木薯蚕丝等。
仿真花	仿真花，是指用绷绢、皱纸、涤纶、塑料、水晶等材料制成的假花，以及用鲜花烘成的干花，业界泛称为人造花。
哺乳	哺乳衣分外穿和内穿两类，外穿的哺乳衣是指一种专为哺乳期妈妈设计的服装，特征是在双侧乳房位置设有两个活外出是2005年许振豪执导电影，电影讲述了瑞英孙艺珍的丈夫不幸遭遇车祸成为植物人，她却与车祸当时跟丈。
上衣	词目上衣拼音shngy英文Tops;Coat;Jacket解释1.外衣。
小型	老鹰，也叫鸢，是小型猛禽，雄鸟体长性2154厘米，雌鸟体长6491厘米，雌鸟比雄鸟大，性凶猛，嘴黄色太空棉是一种开放式细胞结构，具有温感减压特性，可制作各种服装、特种职业装、鞋、帽、床上用品、帐篷及门。
灯芯绒	灯芯绒外套是一款装扮小游戏，游戏大小为832K。
妈妈	妈妈是由美国环球影业发行的恐怖惊悚片，由安德斯穆斯切蒂执导，杰西卡查斯坦、尼可拉科斯特瓦尔道、梅根查燕窝又称燕菜、燕根、燕蔬菜，是指雨燕目雨燕科的部分雨燕和金丝燕属的几种金丝燕分泌出来的唾液，再混合其。
呢子	呢子，一种较厚较密的毛织品，多用来做制服、大衣等。
简易	一简即简单，易即容易，综合为简易，也就是简单容易的缩写。
吸尘器	吸尘器按结构可分为立式、卧式和便携式。
10	S10C机械强度低，塑性、韧性好，冷状态下容易模压成形，容易切削加工，焊接性能好，为提高表面硬度可进舒适1916年4月19日2015年6月26日，男，原名舒昌格，祖籍浙江慈溪，持志大学肄业。
吃饭	解释为，专供吃饭的宽敞房子。
餐厅	餐厅就是指在一定场所，公开地对一般大众提供食品、饮料等餐饮的设施或公共餐饮屋。
轻薄	做旧，做旧zuojiunamedescriptionmetanamekeywordscontent做麻纱，一种布料，布面纵向有细条织纹的轻薄棉织物。
衣架	衣架是用来搭披衣衫的架子。
雪纺	雪纺是丝产品中的纱不是纺类产品，名称来自英语Chiffon的音义，意为轻薄透明的织物，具有织物轻薄、。
舒适	舒适1916年4月19日2015年6月26日，男，原名舒昌格，祖籍浙江慈溪，持志大学肄业。
破洞	蝙蝠袖batwingsleeve又称蝴蝶衫、蝙蝠衫，是一种服装款式，即在肩袖连接处，袖窿深即腰节附近这种缺陷破洞是指织物上未被染上色的地方，这种缺陷的产生是由于夹在织物边缘上的金属小夹子所造成的，这些。
羊毛衫	1羊毛衫本指用羊毛织制的针织衫，这也是一般老百姓认同的含义，而实际上羊毛衫现在已成为一类产品的代名词高领，男，汉族，1961年3月出生，河北蔚县人，大学学士，1988年10月入党，1984年7月参加工打底衫就是可以直接穿在身上的，里面再穿件内衣比如文胸然后可以搭配任何贴身穿的衣服，一般全部叫打底衫。
18	原身出堆堆领又叫自由领，领宽以95码为标准，一般领宽18.5CM，没领深，领高20CM。
神器	三神器日语三种神器一词来源于日本的神话传说，天丛云剑草薙剑，八尺琼勾玉，八咫镜。
组装	组装是一个汉语词语，意思是组合在一起然后再安装到一部机器上。
枕头	枕头，是一种睡眠工具。
入耳式	入耳式耳机，又名耳道式耳机、入耳式耳塞、或者入耳式监听器即IEM的英文全称InEarMonitor，收纳器是2006年上映的瑞典电影，由LukasMoodysson执导，JenaMalone、Pete。
奶粉	用料材料大庆奶粉做法1.1...乳牛因为乳房构造有利于泌乳，乳牛和乳汁有很高的科学价值，又因为乳牛本身对环境适应能力强，所以容易饲养中老年奶粉是根据中老年人的生理特点和营养需求，以优质鲜牛奶为主要原料，采用先进的生产工艺和设备精制而益生菌是一类对宿主有益的活性微生物，是定植于人体肠道、生殖系统内，口腔，能产生确切健康功效从而改善宿。
干花	干花Flower39;flau，即利用干燥剂等使鲜花迅速脱水而制成的花。
圆头	圆头发型，又称卡尺头，卡尺的意思大概就是指其长短一致，就像是用。
裙子	裙子指一种围在腰部以下的服装，多为女子着装。
毛线衣	一种编织毛线衣物的用具，较粗，多用竹子削制而成。
白色	白色是一种包含光谱中所有颜色光的颜色，通常被认为是无色的，但和黑色的无色正相反，其明度最高，色相为零跑步，是指陆生动物使用足部，移动最快捷的方法。
筷子	筷子古称箸，一种由中国汉族发明的非常具有民族特色的进食工具。
一体机	血压bloodpressure，BP是指血液在血管内流动时作用于单位面积血管壁的侧压力，它是推动血液一体机，分为有影印一体机和电脑一体机。
pu	布丁是英语pudding的音译，中文意译则为奶冻。
巧克力	巧克力礼盒是一款益智小游戏，游戏大小为366K。
布艺	防尘罩，是用来保护物品的可以保护物品的表面不受外界的腐蚀和破坏...布艺即指布上的艺术，是古时期中国民间工艺中的一朵瑰丽的奇葩。
卫衣	卫衣诞生于20世纪30年代的美国纽约，当时是为冷库工作者生产的工装。
吸顶灯	吸顶灯是灯具的一种，顾名思义是由于灯具上方较平，安装时底部完全贴在屋顶上所以称之为吸顶灯。
长款	长款大衣是秋冬的必备单品，无论搭配短靴还是长靴都别有味道。
保温	安化县位于资水中游，湘中偏北，雪峰山北段，东与桃江、宁乡接壤，南与涟源，新化毗邻，西与溆浦、沅陵交界普洱茶学名Camelliasinensisvar.assamica，大乔木，高达16米，嫩枝有微毛，保温是一种科学、高效的节能技术措施，可以使热量的散发传导速度减慢。
美特斯	美特斯邦威是美特斯邦威集团自主创立的本土休闲服品牌。
便携	便携binxi，汉语词语，释义为方便随身携带。
温馨	温馨是一个词语，注音是wnxn，意思是温柔甜美，温暖馨香，简单易懂。
陶瓷餐具	陶瓷餐具，陶瓷的传统概念是指所有以粘土等无机非金属矿物为原料的人工工业产品。
36	37是36与38之间的自然数。
红酒	红酒Redwine是葡萄酒的一种，并不一定特指红葡萄酒。
2017	2017为应用最早的一种硬铝,一般称为标准硬铝,具有中等强度,在退火、刚淬火和热状态下可塑性尚好,可新款，读音xnkun，汉语词语，指新的款式。
阳台	菩萨由凡夫修行成佛要经过欢喜地等十地才能达到佛果，初地以上叫做地上，初地以前叫做地前，地前是属于凡夫阳台是建筑物室内的延伸，是居住者呼吸新鲜空气、晾晒衣物、摆放盆栽的场所，其设计需要兼顾实用与美观的原科马拉风格文物,科利马,西墨西哥，约公元前200年公元300年，烧陶，高37厘米宽26厘米厚17厘米。
水果	水果，是指多汁且主要味觉为甜味和酸味，可食用的植物果实。
超轻	超轻粘土，是纸黏土里的一种，简称超轻土，捏塑起来更容易更舒适，更适合造型，且作品很可爱，在日本比较盛彩泥少年儿童用来制作创意造型的一种益智玩具，但工艺和材质上比橡皮泥要提高不少，柔软而不粘手。
毛毯	毛毯英文Blanket是一种常用的床上用品，具有保暖功能，与被子相比较薄。
蝴蝶结	蝴蝶结又可以称同心结，外形酷似蝴蝶，制作材质也是不尽相同，形状大小不一，但外形美观大方，其打法有很多2018是2017与2019间的自然数，2018的倒数是12018，相反数是2018，2018的绝对。
原创	原创是独立完成的创作。
门厅	门厅为进门大厅，一般在进门的地方的缓冲区。
过滤	超滤UltraFiltrationUF，超滤是利用膜的筛分作用进行分离的膜过程，与MF相比，其过滤精Corei7中文酷睿i7，核心代号Bloomfield处理器是英特尔于2008年推出的64位四核心C学生student一般指正在学校、学堂或其他学习地方如家中、军队等等受教育的人，而在研究机构或工作单台湾华硕电脑股份有限公司是目前全球第一大主板生产商、全球第三大显卡生产商，同时也是全球领先的3C解决。
艺术	艺术，迄今还没有公认的定义。
防水	防水早已不再是一个新鲜的话题，不论是隧道、桥梁、堤坝、道路、建筑还是我们日常居住的房屋，防水都不容忽特价，特别优惠的价格、特别低廉价格的简称。
床垫	床垫是为了保证消费者获得健康而又舒适的睡眠而使用的一种介于人体和床之间的物品，床垫材质繁多，不同材料。
马切	马切达，全名费德里科马切达FedericoMacheda，1991年8月22日出生于意大利罗马，意大做旧，做旧zuojiunamedescriptionmetanamekeywordscontent做。
女鞋	女鞋，是现今女性日常服饰搭配中不可缺少的一项。
玄关	玄关柜是指厅堂的外门，也就是居室入口的一个区域，具有装饰、保持主人的私密性、方便主人换鞋脱帽等多种作。
毛呢	毛呢外套，有韩版毛呢，日系毛呢，修身毛呢，羊绒大衣，斗篷大衣等。
不锈钢	不锈钢指耐空气、蒸汽、水等弱腐蚀介质和酸、碱、盐等化学浸蚀性介质腐蚀的钢，又称不锈耐酸钢。
电脑桌	电脑桌是一种用来放电脑的桌子。
正装	所谓正装，是指适用于严肃的场合的正式服装，正装就是正式场合的装束，而非娱乐和居家环境的装束。
泰国	那瓦蓬朴提岸White，1995年6月2日出生于泰国曼谷，泰国男演员，毕业于曼谷大学。
铅笔	铅笔裤，源于英文PencilPants，起源于欧洲。
挂件	五金挂件，指安装于卫生间的，用于挂晾衣物的挂壁式的金属制品。
磨砂	我们一般说的磨砂就是将原本表面光滑的物体变得不光滑，使光照射在表面形成漫反射状的一道工序。
气质	气质是指人的相对稳定的个性特点和风格气度。
长方形	长方形，数学术语，是有一个角是直角的平行四边形叫做长方形。
夜光	夜光读音ygung，是指月亮、星星、路灯等在夜晚发出的光。
通用	USB，是英文UniversalSerialBus通用串行总线的缩写，是一个外部总线标准，用于规范电充电宝powerbank或powerbank是指可以直接给移动设备充电且自身具有储电单元的装置。
英寸	英寸吋是使用于联合王国UK,即英国英联邦及其前殖民地的长度单位，一般为1in2.54cm，在英制里，Corei7中文酷睿i7，核心代号Bloomfield处理器是英特尔于2008年推出的64位四核心C8000是介于7999与8001之间的自然数，同时也是一个简单的阿拉伯数字。
秋冬	秋冬女装是一款休闲游戏，游戏大小为941.24K。
花花公子	花花公子是花花公子企业国际有限公司的品牌，英文名PlayboyEnterprisesInternat。
30	4月是阳历年中的第四个月，是全年第一个小月，共有30天。
浴盆	足浴盆指用于足部冲洗按摩的容器。
迷彩	迷彩鞋，其鞋面、鞋身都是由迷彩色布料做成，鞋底一般为褐色或者是黑色，鞋带一般为黑色或者绿色。
浴室	浴室是2006年由南海出版社出版的图书，作者是深圳市金版文化发展有限公司。
卫生间	IEEEInstituteofElectricalandElectronicsEngineers，美卫生间就是厕所、洗手间、浴池的合称。
冬天	虽然冬天已经过去了，可是天气依旧寒冷，出门保暖是非常重要的，现在我们一起来看看保暖上衣加外套的搭配吧。
台灯	台灯Desklamp，是灯的一种，小巧精致，方便携带。
咖啡杯	咖啡杯由负离子粉、电气石、优质粘土和其它基础材料烧结而成。
包邮	包邮简单的讲即包邮的商品的价格加邮费，拍下后不用补邮费差价。
时尚	时尚这个词现在已是很流行的了，英文为fashion，该词来源于拉丁文facioorfactio，意思汉语词语，所谓信用，是指依附在人之间、单位之间和商品交易之间形成的一种相互信任的生产关系和社会关系。
软底	布靴是一种用粗布缝制的软底长靴，结实耐用，是很常见的靴子。
系带	系带是一个汉语词汇，就是指主要用于捆扎包装物的窄形织品。
砧板	砧板zhnbn捶、切、剁、砸东西时垫在底下的器物,一般用在亨调上砧板元关汉卿望江亭第三折可将砧板、刀菜板即砧板，是垫放在桌上以便切菜时防止破坏桌子的木板。
羊羔	羊羔毛英文名LambWool又叫羊仔毛，是冬天衣服里面常用的一种材质，因其保暖性和时尚感并重而大受欢加大码是林子祥演唱的歌曲，由林振强作词，rodneytemperton作曲，收录在专辑千亿个夜晚中。
学院	学院风preppystyle是一种着装风格，以美国常春藤名校校园着装为代表。
轻便	基本信息词语轻便拼音qngbin解释light;portable轻松方便...山地，是指海拔在500米以上的高地，起伏很大，坡度陡峻，沟谷幽深，一般多呈脉状分布。
潮流	潮流的定义就是流行趋势的动向，引申意思是社会变动或发展的趋势。
加热	加热是指热源将热能传给较冷物体而使其变热的过程。
伸缩	浴帘杆，指的是用来悬挂浴帘的伸缩支撑杆，使用简单，价格便宜，更换方便。
茶盘	茶托，是指在酒吧，茶馆，咖啡厅等高消费的场所，安排服务员上网与人聊天，以交朋友等理由为诱饵，诱骗他人鸡翅木茶盘主要适用于乌龙茶、普洱、绿茶、花茶等功夫茶道是用上等非洲鸡翅木做成的。
跑鞋	跑鞋又名运动鞋，根据生物力学的需要跑鞋可分为提供减震性、提供稳定性、提供运动控制三大类。
零食	零食，通常是指一日三餐时间点之外的时间里所食用的食品。
无袖	无袖连衣裙是一款2013年上线的装扮小游戏。
日式	日式沙发最大的特点要数它的成栅栏状的小扶手和矮小的设计。
361	361，是360和362之间的自然数。
无线	无线英文wireless。
蛋糕	慕斯蛋糕是一种以慕斯粉为主材料的糕点。
烤箱	烤箱是一种密封的用来烤食物或烘干产品的电器，分为家用电器和工业烤箱。
日本	奇骏日产XTRAIL是2000年底在日本推出的一款车型，是一款非常经典的SUV.直指同级对手丰田ra14，是第十四个阿拉伯数字，也是介于13到15的自然数。
装饰品	咖啡馆之所以有它独特的吸引人之处装饰品是可以起到修饰美化作用的物品，比如装修效果图造型的轮廓和雕刻装饰。
衣品	衣品天成EPTISON是杭州丹度电子商务有限公司旗下潮流品牌，由CEO杜立江于2010年成立。
迷你	迷你，是从香港、澳门地区传入的外来语，目前已常用于生活之中，指同类中的极小者。
车载	所谓车载手机支架，可以用最舒适的方式来使用的、最简约、易用数码支架，注重用户体验、优秀的结构设计，根拉斯是铁拳6BR中角色拉斯亚历桑德森LarsAlexandersson也有译为拉尔斯向世界宣战的三岛。
幼儿园	幼儿园，旧称蒙养园、幼稚园，为一种学前教育机构，用于对幼儿集中进行保育和教育，通常接纳三至六周岁的幼儿童画笔是一款儿童类网页游戏。
花器	所谓花器即是指栽种花草之容器的总称。
浅色	浅色浅色拼音qins解释1.。
婚庆	婚庆，具体来说指的是婚礼庆典策划。
开衫	开衫外套是淑女常见的一种外套服装。
长裙	长裙裙摆至胫中以下，裙子的一种。
猫咪	猫粮也称猫食，是猫咪吃的食物的总称。
马克杯	本词条内容尚未完善，欢迎各位编辑词条，贡献自己的专业知识！xiaoshaonamedescripti马克杯的意思是大柄杯子，因为马克杯的英文叫mug，所以翻译成马克杯。
游戏	重磅，拼音zhongbang，指非常重大的消息或事件等...天空蓝是一款装扮小游戏，游戏包大小为830K。
炒锅	炒锅是中国一种烹饪工具，为锅的一种，特征是顶部开口大，圆底，由于中国南方食物多以小炒为主，故炒锅设计煤气是以煤为原料加工制得的含有可燃组分的气体。
新款	新款，读音xnkun，汉语词语，指新的款式。
男包	佐汉男包专业打造属于每个客户的格调和品位，让客户都拥有一款属于自己品位和心动的包包。
汤锅	生铁是含碳量大于2的铁碳合金，工业生铁含碳量一般在2.114.3，并含C、Si、Mn、S、P等元素，汤锅，指屠宰场用的煺毛的大锅。
微波炉	微波炉microwaveoven，是一种常见的家用电器，是用微波加热食品的现代化烹调灶具。
拆洗	拆洗，指把棉衣、棉被等拆开洗净，再缝上。
250g	用料材料用量意大利面250gpomodorosauce俩大汤匙鸡胸肉30g白蒜头3分之1大葱4分之1。
金属	储油罐，简称油罐或者储罐，是用于储存油品的且具有较规则形体的大型容器，按建造材料的不同可以分为金属油厨房，假名，简称为厨，是指可在内准备食物并进行烹饪的房间，一个现代化的厨房通常有的设备包括炉具瓦斯炉不锈钢指耐空气、蒸汽、水等弱腐蚀介质和酸、碱、盐等化学浸蚀性介质腐蚀的钢，又称不锈耐酸钢。
棉鞋	棉鞋套。
打孔	小叶紫檀手串是用小叶紫檀材料制成的佛珠，经过选料开料成圆打孔磨光抛光，最后形成成品佛珠。
商务	商务概念的提出是改革的产物，有一个演变的过程贸易部商业部、外贸部内贸部内贸局商务部。
宽松	一般来说，我们以前穿的宽松的裤子，稍微有点弹力都可以当作瑜伽裤，针织的、棉的、麻的都可以。
全铜	所有垂吊下来的铜灯都归入全铜吊灯类别。
耐高温	刘嘉亮演唱的歌曲词曲刘嘉亮刘薇杨世云演唱刘嘉亮要唱出最动人的旋律要亮出最美的你世界就在前方等着你每一仿皮是用合成材料制成，它不怕蛀，不易发霉，表面耐水性好，但合成革不耐高温，不耐化学物质侵蚀。
皮草	皮草外套是一款装扮类网页游戏。
单鞋	单鞋就是单层皮或单层布的鞋。
恒源祥	恒源祥，首个以企业身份主办有体坛奥斯卡之称的劳伦斯世界体育奖颁奖盛典的中华老字号品牌企业，同时也是中套头针织衫是一种没有扣子的秋冬服装，...。
特级	特级是一个词语，意思是特别高的等级。
收口	收口，指编织物开口处收拢起来。
恒温	恒温专业术语用人工或自动控制方法保持温度值的恒定不变。
机车	机车是牵引或推送铁路车辆运行，而本身不装载营业载荷的自推进车辆，俗称火车头。
芝士	cheesecaken.酪饼,由干酪，蛋和糖等混合后焙制而成半裸体或露出曲线美的女人照片芝士cheese，又名奶酪、乳酪，或译称干酪、起司、起士，是乳制食品的通称，有各式各样的味道、口感和石磨最初叫硙wei，汉代才叫做磨，是用于把米、麦、豆等粮食加工成粉、浆的一种机械。
新品	新品是作者逆天良少发表在幻剑书盟连载网站的一本小说。
地垫	地垫是一种能有效地在入口处刮除泥尘和水份，保持室内地面整洁的产品。
青年	青年一词的含义在全世界不同的社会中是不同的，而青年的定义随着政治经济和社会文化环境的变幻一直在变化。
纯棉	纯棉衬衫一般100棉，纯棉衬衫具有透气、柔软、舒适、凉爽、吸汗的优点，缺点是衬衫容易损坏，成本较高。
时钟	秒针是指时钟上面以秒为单位移动的指针，每移动一大格即为1秒钟。
法兰绒	法兰绒Flano，Flannel一词系外来语，是一种用粗梳棉毛纱织制的柔软而有绒面的棉毛织物。
黑色	黑色基本定义为没有任何可见光进入视觉范围，和白色正相反，白色是所有可见光光谱内的光都同时进入视觉范围直邮英文简称DM，指具有个人资讯PersonalInformation的功能，通过DM的媒体进行寄递秒针是指时钟上面以秒为单位移动的指针，每移动一大格即为1秒钟。
碎花	碎花裙，是运用丝缎等面料，搭配素雅的花样图案或者波点、碎花图案的一种特别流行的裙子，可以让你完成从少荷叶边，指形似荷叶的服装边。
整箱	啤酒是以大麦芽为主要原料，大米为淀粉类辅料，并加啤酒花，经过液态糊化和糖化，再经过液态发酵而酿制成的整箱也称整箱货fullcontainerload简称FCL，是货运代理中的专业术语。
弹力	玻尿酸，它的水溶液为粘弹性流体，填充在皮肤组织细胞与胶原纤维的空间中，当玻尿酸吸收水分后，使得弹力纤进口，是指向非居民购买生产或消费所需的原材料、产品、服务。
防风	抹胸是一种胸间贴身小衣，一般以方尺之布制成，紧束前胸，以防风之侵入。
玩具	麦克风，学名为传声器，是将声音信号转换为电信号的能量转换器件，由quot;Microphonequo玩具积木是儿童玩具之一，趣味性、娱乐性相结合，深受儿童喜爱。
礼物	礼物是在社会交往中，为了表达祝福和心意或以示友好，人与人之间互赠的物品。
韩式	材料韩式辣椒酱50公克，淡口酱油1大匙，味噌30公克，姜汁1小匙，蒜泥1小匙，芝麻油1大匙，熟白芝麻炒年糕是中国传统年节特色食品。
餐边	餐边柜碗碟柜是放在餐厅空处或餐桌一边具有收纳功能的储物柜，可以供放置碗碟筷、酒类、饮料类，以及临时放餐桌椅是指餐厅里面吃饭时需要的桌椅，市场上出售的餐桌，以原木色泽的为最多，分为实木和人造板两种。
冲锋衣	登山mountaineering是指在特定要求下，运动员徒手或使用专门装备，从低海拔地形向高海拔山峰冲锋衣，外文名Jackets，又名OutdoorJackets，音译为夹克，户外运动必备装备之一。
泡茶	泡茶器的定义是只要能泡出茶来的器具。
水果盘	水果盘英文为FreshFruitPlatter，是一种主要盛放水果、瓜子等的容器，具有方便、循环利用。
沥水	沥水是一个汉语词汇，意思是积在地面上的雨水。
高端	尚品是奢侈品与高端时尚全购物平台，旗下拥有尚品网和尚品奥莱两家网站。
oversize	oversizeadj.。
2019	公元2019年，公历平年，共365天，53周。
运动	蹦床Trampoline是一项运动员利用从蹦床反弹中表现杂技技巧的竞技运动，它属于体操运动的一种，蹦。
休闲鞋	椰子学名CocosnuciferaL.休闲鞋是鞋类的一种，主要特色是以一种简单，舒适的设计理念，满足人们日常生活穿着的需求。
高清	高清，英文为HighDefinition，意思是高分辨率。
床单	床单，床上用纺织品之一，也称被单。
工装	Ulzzang，即eolzzang，eol在韩语中是脸蛋eolgul的第一个音，zzang为网络用语工装是为工作需要而特制的服装。
桌子	桌子是一部有金宗宽导演、编剧，林秀晶、郑有美、韩艺礼、郑恩彩、延宇振主演的韩国电影。
玻璃	玻璃茶壶分为普通玻璃茶壶和耐热玻璃茶壶。
三合一	三合一咖啡亦称速溶咖啡、即溶咖啡是指内含奶精、糖、咖啡混合而成的并且是速溶的。
毛绒	艾米莉布朗宁饰演的摇滚唱作人是毛绒乐队主唱，婚姻幸福，双子绕膝，事业蒸蒸日上。
小熊	小熊是一款专为安卓手机系统开发的壁纸美化类软件，可在91桌面下载。
加长	加长杆是为表面粗糙度测量仪设计的，它可以将粗糙度仪的传感器长度增加100mm或200mm，以测量内孔组合，汉语词语.，既可以作为名词又可以作为动词使用。
储物柜	置物柜也叫储物柜，置物柜是一种放置物品的全封闭式的金属储物器具，适用于库房、车间和生产办公场所，存放。
套餐	套餐，原只指一整套的饭，后来也指一系列的活动等。
美的	美的集团SZ.000333是一家领先的消费电器、暖通空调、机器人及工业自动化系统、智能供应链物流的科写字是一个汉语词汇，读音为xiz，写字是人类表达思想的原始的基本方式之一。
马丁	乔治雷蒙德理查德马丁GeorgeRaymondRichardMartin，通常被称为乔治RR马丁或G。
雕花	菜刀是一种厨房用具，主要用途是切食材或者食材雕花等。
休闲裤	通常指一种色彩，有时也用作形容词，表示阴暗、消极...休闲裤就是穿起来显得比较休闲随意的裤子。
椅子	菩萨由凡夫修行成佛要经过欢喜地等十地才能达到佛果，初地以上叫做地上，初地以前叫做地前，地前是属于凡夫古代席地而坐，原没有椅子，椅本是木名。
空调	空调毯又称夏被毛巾被，它凭借着它良好的透气性，易洗涤，易收纳等特点，成为很多人夏季必备的床上用品。
小童	小童，拼音是xaotng，出自石钟山记，解释为幼童。
静音	静音是日本动漫火影忍者中的角色，日文，木叶隐村的上忍，纲手早期的弟子之一，春野樱的师姐。
设计	珠宝盒的制作及生产都基于珠宝首饰的发明，内部一般采用多间隔式设计，防止首饰接触所带来的不必要的划痕，手工指非机器设备批量生产而是由人工制作生产。
饰品	吊坠，一种首饰，配戴在脖子上的饰品，多为金属制，特别是不锈钢制和银制，也有矿石、水晶、玉石等制的，主定制一词起源于萨维尔街，意思是为个别客户量身剪裁。
智能	智能，是智力和能力的总称，中国古代思想家一般把智与能看做是两个相对独立的概念。
韩版	韩版风衣是一款装扮类网页游戏。
直营	清洗是采用一种化学药剂清除物体表面污垢的方法，它是借助清洗剂表面污染物或复盖层进行化学转化、溶解、剥直营，就是指由公司总部直接投资经营，这种以一个品牌为主导，在各地投资设立分公司或子公司的经营管理模式口罩一般指戴在口鼻部位用于过滤进出口鼻的空气，以达到阻挡有害的气体、气味、飞沫进出佩戴者口鼻的用具，防尘，读音fngchn，汉语词语，基本意思为不透尘埃的;紧得灰尘不能进入的。
持久	北京中关村为王持久作词，孙川谱曲，蔡国庆演唱的晚会歌曲，赞美了北京中关村作为电子科技产品的聚集地飞速整个国家指一个国家全部资源，如人民、领土，译自nation，双音节词，偏正结构，来自日语的原语汉字借创意creativity是创造意识或创新意识的简称，亦作剙意。
幼儿	幼儿。
水杯	水杯汉语拼音是shubi，英语名是cup。
盘子	盘子，指盛放物品多为食物的浅底的器具，比碟子大，多为圆形。
装饰	迎宾踏板是一种用于装饰汽车门槛部位，起到保护车体、美化车体作用的汽车配件，属于汽车改装用品里的一种。
置物架	置物架是采用底板及支柱组合而成放置杂物的架子。
天然	抹茶粉是抹茶的通俗形象叫法，是采用天然石磨碾磨成微粉状的蒸青绿茶。
香薰	香薰是一种风靡全球，倍受爱美女士青睐的护理方式。
北欧	北欧NordicEurope是政治地理名词，特指北欧理事会的五个主权国家瑞典、挪威、芬兰、丹麦、冰岛。
壁画	壁画，墙壁上的艺术，即人们直接画在墙面上的画。
宿舍	宿舍是住宿的房屋，包括寝室、卫生间、洗浴间、阳台等。
bb	兔毛rabbithair家兔毛和野兔毛的统称。
单肩	小脑的前面可见一对特殊的结构，呈球状位于小脑中脚的下方，称为绒球，其向内侧借绒球脚与小结相接，绒球、单肩包，顾名思义是指单边肩膀受力的包，又分单肩挎包和斜挎包。
涂层	涂层coating是涂料一次施涂所得到的固态连续膜，是为了防护，绝缘，装饰等目的，涂布于金属，织物，采用特殊的含有磁化分子的航天超硬特种陶瓷合金一次精铸成型，整合传导、对流、辐射原理，导热系数高达1730三十，卅是29与31之间的自然数。
胡桃木	简介箱内有胡桃木做的保密抽屉。
40	据尚书载，远在4000多年前的章服制度，就规定衣画而裳绣。
洗菜	洗菜机是一款专门清洗水果蔬菜的机器，有商用洗菜机和家用洗菜机两大类。
双层	上铺拼音解释1.双层铺的上面一个铺位。
餐具	餐具指用餐时直接接触食物的非可食性工具，用于辅助食物分发或摄取食物的器皿和用具。
布艺沙发	形容物体的不一样性词目大小拼音dxio...布艺沙发主要是指主料是用布的沙发，经过艺术加工，达到一定的艺术效果，满足人们的生活需求。
桌布	释义词目桌布拼音zhub定义桌布又称台布，英文名tablecloth为覆盖于台面、桌面上用以防污或增。
哈衣	哈衣，又称连身衣、连体衣、爬服，还没这个概念的，也是一种新式服装。
海宁	嘉兴市海宁贝乐皮草股份有限公司创立于1994年，是一家从事生产、加工、销售，并拥有自营出口权的生产企幼儿园，旧称蒙养园、幼稚园，为一种学前教育机构，用于对幼儿集中进行保育和教育，通常接纳三至六周岁的幼体育physicaleducation，缩写PE或P.E.，是一种复杂的社会文化现象，它以身体与智力户外，是汉语词汇，汉语拼音为hwi，指室外露天处，与室内有区别户外活动也就是露天场所的活动。
沙拉	沙拉是用各种凉透了的熟料或是可以直接食用的生料加工成较小的形状后，再加入调味品或浇上各种冷少司或冷调。
收纳	收纳架是指利用金属、塑胶、实木等制作的用来收纳物品的架子。
苏泊尔	浙江苏泊尔股份有限公司是中国最大、全球第二的炊具研发制造商，中国厨房小家电领先品牌，是中国炊具行业首电饼铛chng是一个烹饪食物的工具，上下两面同时加热使中间的食物经过高温加热，达到烹煮食物的目的。
文艺	文艺Literatureandart文学和艺术，有时指文学或表演艺术，是人们对生活的提炼，升华和表达小众是一个汉语词汇，读音为xiozhng就是目前来说只被少数人接受的事情和爱好。
德国	博世是德国的工业企业之一，从事汽车与智能交通技术、工业技术、消费品和能源及建筑技术的产业。
安踏	安踏体育用品有限公司港交所2020，简称安踏体育、安踏，是中国领先的体育用品企业，主要从事设计、开发男鞋字面上理解为男式鞋。
陶瓷	陶瓷座便器是由粘土或其他无机物质经混练、成型、高温烧制而成、吸水率0.5、用于建筑物卫生间的有釉陶瓷。
高腰	高腰是明显高于自然腰节线的腰线位置。
头戴式	头戴式耳机，顾名思义是戴在头上，并非插入耳道内，区别于入耳式耳塞的一类耳机。
bf	部分是一个汉语词汇，读音为bfen，一般指整体中的局部。
宜家	宜家家居IKEA于1943年创建于瑞典，瑞典宜家集团已成为全球最大的家具家居用品商家，销售主要包括座北欧NordicEurope是政治地理名词，特指北欧理事会的五个主权国家瑞典、挪威、芬兰、丹麦、冰岛清新，词语，拼音qngxn，指清爽而新鲜，中国古典诗词有相关语言风格道家哲学思想。
麻辣	麻辣香肠是四川的一种灌肠类品种，其色、香、味、形等均与其它香肠有异，进食时香辣味重，咸中带甜，稍有麻辣肠是一道美食，主料是猪肉，配料是猪小肠，调料是味精、花椒、胡椒面等，本菜品主要通过将去皮猪肉切丁腌大爷是称呼语，有两种发音dy。
帽子	帽子有遮阳、装饰、增温和防护等作用。
套件	套件是一款电脑软件，软件大小为1.9MB。
双肩	双肩背包是连载在红袖添香网的言情类小说，作者是BeibeiPandora。
摆件	摆件，就是摆放在公共区域、桌、柜或者橱里供人欣赏的东西，范围相当广泛。
板鞋	板鞋是平地式板式的鞋。
西裤	西裤trousers主要指与西装上衣配套穿着的裤子。
帆布	挎包常指皮革、人造革或帆布制的平底、附有背带的。
连衣裙	露肩连衣裙是quot;换装quot;系列游戏的一个flash小游戏，flash小游戏是一种通过Fla韩都衣舍电商集团创立于2006年，是中国最大的互联网品牌生态运营集团之一。
奶瓶	奶瓶，是用来盛奶的一种器具，一般给婴儿使用。
小吃	小吃是一类在口味上具有特定风格特色的食品的总称。
春秋装	春秋装拼音解释春秋季节穿着的服装。
男孩	男孩指年轻的男性人类。
组合	组合，汉语词语.，既可以作为名词又可以作为动词使用。
高帮	高帮是鞋帮最高的鞋，高帮鞋的鞋帮可以完全包裹住脚踝，更好的保护脚踝，但是在运动时显得比较笨重，不宜运该词条最初来源于服装。
春季	新茶，是指当年春季从茶树上采摘的头几批鲜叶加工而成的茶叶。
点心	西饼是指来自西方国家的西式点心与糕饼。
增高	增高的方法大致分为两种一是穿增高鞋。
斜挎包	斜挎包，顾名思义就是可以斜背的包。
衬衣	衬衣shirt，underclothes是指贴身穿在里面的单衣，也称衬衫。
包包	帆布包是手袋包包的一种类别，是用环保材料帆布经过加工而成。
果盘	高脚果盘是保罗塞尚41岁时的作品，它也是保罗塞尚成就最高、最著名的静物画之一。
积木	积木有平面和立体两种。
衬衫	领带是上装领部的服饰件，系在衬衫领子上并在胸前打结，广义上包括领结。
植物	深圳市东鹏饮料实业有限公司拥有功能饮料、植物饮料、清凉饮料、豆制品、水和陈皮蜜饯等各类产品。
花架	花几又称花架或者花台，俗称高花几。
两用	两用，拼音langyng，是指并用。
球鞋	球鞋是歌手川岛茉树代的专辑再见17岁中收录的一首歌，由葛大为作词作曲。
枕套	枕套pillowcase就是在枕巾下面、包裹枕芯的东西，像一个布口袋。
田园	田园，女，来自黑龙江哈尔滨，自己经营着一家咖啡馆。
中老年人	老人机，通常是指适用于中老年人的手机产品，该产品一般功能单一，老年手机被卡老年群体广泛使用，对国家布诺基亚公司NokiaCorporation是一家总部位于芬兰埃斯波，主要从事移动通信设备生产和相关服。
桌面	应用介绍应用于91熊猫桌面的主题，已包含91熊猫桌面插件使用方法1、已经是91熊猫桌面的用户可以直接马克杯的意思是大柄杯子，因为马克杯的英文叫mug，所以翻译成马克杯。
公仔	公仔玩具公仔玩具图片公仔玩具是由香港传过来的一种说法，主要是指玩偶的意思。
唐狮	唐狮以打造同行业最优秀品牌为己任。
脚垫	脚垫主要是由于角质层老化，脚部经络血液循环不畅、皮肤长期受挤压或摩擦皮下水分与功能失衡而导致的角质增地毯是用动物毛、植物麻、合成纤维等为原料，经过编织、裁剪等加工过程制造的一种高档地面装饰材料。
手工	手工编织是2006年中国劳动社会保障出版社出版的图书，属于职业技能短期培训教材，该书系统介绍了棒针编主要指男人和女人，男属阳，女属阴。
字母	当单位来源于人名时，符号的第一个字母必须大施巴由德国波昂大学皮肤科的海兹默尔医师在1952年时的革命性创举及之后50年代后期艾根教授领导的研究。
针织衫	针织衫是利用织针把各种原料和品种的纱线构成线圈，再经串套连接成针织物的工艺产物，即利用织针编织成的衣女士穿着的衣物统称为女装。
套装	套装，指经精心设计，有上下衣裤配套或衣裙配套，或外衣和衬衫配套。
正宗	词目正宗，读作zhngzng，最早出于宋陈师道请兴化禅师疏绍雪门之正宗，入慧林之半座。
防滑	涉水鞋，又叫溯溪鞋水陆两栖鞋排水鞋，是指能够防滑、排水拒水甚至遇湿后可以快速干的鞋子。
usb	园艺horticulture，即园地栽培gardenhusbandry，果树、蔬菜和观赏植物的栽培、挂在墙壁上的一种装饰性织物。
新鲜	新鲜形容物品生产日期很近，没有遭受过多的污染。
森马	森马，国内休闲服行业迅速崛起的领军品牌。
辅食	辅食是完整营养均衡，对成长中的孩子是很重要的，特别是在0岁阶段的营养给予，更是奠定宝宝一生健康的根基CM是多种意思的英文缩写。
专业	专业的夜视在你的小装置！复杂的算法用于我们的应用程序允许您实时看到更好的夜间或简单地在黑暗的。
音乐	其作用与发送器的作用相反,主要是将信道中的信号接收下来，并将其变换成与发送时物理形式相同的信息,再传音乐播放器是一种用于播放各种音乐文件的多媒体播放软件。
女士	女士穿着的衣物统称为女装。
童鞋	叫叫鞋是童鞋的一种，顾名思义就是儿童穿上它走起路来鞋子会发出各种各样的声音。
夹克	夹克是英文Jacket的译音，指衣长较短、胸围宽松、紧袖口克夫、紧下摆克夫式样的上衣。
纸巾盒	纸巾盒是指盒体顶面开设有取纸口并设有用于盖住取纸口的封盖。
宝宝	宝宝是对小孩儿的亲昵称呼。
燃气灶	燃气灶是指以液化石油气液态、人工煤气、天然气等气体燃料进行直火加热的厨房用具。
保暖	保暖warm，顾名思义指提供一种取暖的手段。
外套	外套，又称为大衣，是穿在最外的服装。
内衣	曼妮芬是汇洁集团成立的第一个内衣品牌，1996年曼妮芬第一家专柜在北京开业，1999年曼妮芬把中国的内衣，是指贴身穿的衣物，包括背心、汗衫、短裤、胸罩等，通常是直接接触皮肤的，是现代人不可少的服饰之一筛网分为金属网和化纤网，其名称叫法有筛网、网纱、丝网等，规格繁多，用途广泛。
垫子	垫子，垫在床、椅子、凳子上或别的地方的东西。
澳洲	澳洲是澳大利亚洲的简称，它位于太平洋西南部和南部、赤道南北的广大海域中。
护肤品	乳液是一种液态霜类护肤品，因为看起来纯白如牛奶，所以叫乳液。
沙发床	或者interse沙发床是指能沙发和床两用的家具。
百搭	Belly肚子，1998年由说唱演员DMX和Nas主演，片中DMXEarlSimmons饰演一个极其蝙蝠袖batwingsleeve又称蝴蝶衫、蝙蝠衫，是一种服装款式，即在肩袖连接处，袖窿深即腰节附近百搭这个词最先是在棋牌游戏中出现的，游戏时一般要组成一种牌组，这种牌组需要特定的几种牌组成。
半身裙	半身裙，因为其适中的长度，可以让小腿和脚踝成为关注的焦点，保守中散发点小性感而成为淑女的大爱单品。
被套	被套是指你的股票买入价高于当前市价,你若卖出则会亏损,一般人不忍心亏本卖出,才会套在其中,所以才有被床单，床上用纺织品之一，也称被单。
移动	野营灯是在营地提供照明，吓跑野兽、指示营地位置等，并且是可移动的灯具。
棉衣	防备寒冷的侵害穿件棉衣，可以。
燃气	燃气是气体燃料的总称，它能燃烧而放出热量，供城市居民和工业企业使用。
苹果	苹果学名Maluspumila是水果的一种，是蔷薇科苹果亚科苹果属植物，其树为落叶乔木。
床笠	床笠简单的说就是是直接套在床垫上的布质罩子，它的主要用途是包裹床垫，床垫本身非常容易落灰弄脏，再加上天丝Tencel是纯天然再生性纤维,是英国Acordis公司以从桉树中提取的100天然木浆为原料研制双人,正如字面上的意思两个人,也就是于自己配合时对自己的称呼。
多功能	多功能是一款IOS平台的应用。
机械	拍照又称为摄影、照相，一般指通过物体所反射的光线使感光介质曝光的过程，通常使用机械照相机或者数码照相消除反应又称脱去反应或是消去反应，是指一种有机化合物分子和其他物质反应，失去部分原子或官能基称为离去。
户外运动	户外运动，是一项在自然场地举行的一组集体项目群。
台式	台笔又称台式概念礼品笔、LPZZS台笔、中性签字笔、广告台式笔等，笔下面有托，笔插在托上，笔尾与托有。
特产	西凤酒，陕西省凤翔县特产，中国国家地理标志产品。
性感	性感是一个汉语词汇，指某个人的文化气质、身材相貌或穿着打扮或动作，唤醒他人感性意识认知的魅力美。
短裤	短裤shorts是遮盖下体至大腿的衣服，因比长裤短而得名，主要有内裤和外裤之分。
现货	现货Actuals亦称实物physicals，指可供出货、储存和制造业使用的实物商品。
毛衣	毛衣编织的历史非常的久远，人类在原始生活中利用树叶、兽皮来蔽体，在渔牧生活中结网捕鱼，就懂得运用编织春秋时期是中国历史东周前半期历史阶段。
地毯	地毯是用动物毛、植物麻、合成纤维等为原料，经过编织、裁剪等加工过程制造的一种高档地面装饰材料。
拖把	拖把，又称墩地抹布，指擦洗地面的长柄清洁工具，亦泛指长柄清洁工具。
男生	型男是指新一代魅力的男生，对个人的生活品位和当今潮流品牌认知的追求不亚于女生。
礼服	晚礼服eveningdress是晚上2000以后穿用的正式礼服，是女士礼服中最高档次、最具特色、充分宴会ynhu，汉语词语，意为会聚宴饮。
茶台	根雕茶台又名根雕茶几、根雕茶桌、根雕茶几、茶海、木雕茶海，是利用大型古树树根制作而成，供喝茶使用！也树根，是汉语词汇，出自孔子家语好生，解释为建立根基。
棉袄	棉袄是一种在冬季穿用的具有很强保暖作用的上衣，这种服装一共有三层，最外一层叫面子，主要是用一些较厚的KAMA是以休闲成熟风为主的服装。
唐装	唐装是中国服饰，但是有两种不同的意义和款式。
粉色	粉钻是指粉色的钻石，成因是钻石呈粉色是因为它的结构发生了变化，所以显粉色。
防晒	军事工防晒是指为达到防止肌肤被晒黑、晒伤等目的而采取一些方法来阻隔或吸收紫外线。
圣诞	圣诞毛衣是格伦贝克根据亲身经历改编而成的故事，一出版即成为纽约时报畅销书排行榜冠军。
平板	平板灯是卧室灯的一种，美观大方，简单实用，采用高档压克力材质，具有节能、环保、防尘、防静电，透光度及集成吊顶是HUV金属方板与电器的组合。
饭桌	饭桌，名词，指供吃饭用的桌子。
毫安	毫安，是电流的计量单位，用字母mA表示。
午睡	午睡是因人体内生物节律起作用而保护生物节律的一种方法。
高街	高街HighStreet，原称第四街，是香港西营盘西半山区的一条街道，单线行车，可容小巴及私家车由东。
飞行员	飞行装具主要包括头盔、面罩、抗荷服和救生衣等，是飞行员飞行训练，作战和遇险救生的重要防护装备。
单人	单人是由潘成、小昔米作词，潘成作曲，杨云祥编曲，江安缩混，朱元冰演唱的一首歌曲。
皮带	皮带belt，皮质的腰带。
面包	面包超人是1988年10月3日关东地区日本TV系列广播电台制作的儿童动画。
清仓	清仓有三种意义一、原义清理查察仓库。
吊带	吊带背心是健康、典雅、时尚的一流精品，它把人体曲线和生理机能相结合，多了几分休闲和动感的意味。
圆领	圆领指领角呈半圆形的领型，也叫圆角领。
镂空	鱼嘴鞋就是指鞋头顶端有一块鱼嘴形镂空，刚好裸露出一两个脚趾的设计，又叫露趾鞋。
耐磨	强化复合地板由耐磨层、装饰层、基层、平衡层组成。
蓝牙	蓝牙耳机就是将蓝牙技术应用在免持耳机上，让使用者可以免除恼人电线的牵绊，自在地以各种方式轻松通话。
铁艺	铁艺，称为铁艺术，有着悠久的历史，传统的铁艺主要运用于建筑、家居、园林的装饰。
全棉	全棉指含棉量为100的衣物或者用品，一般为平布、府绸、斜纹布、劳动布等，与一般布料不同的是它具有防臭羽绒被的填充物主要是羽绒，羽绒是长在鹅、鸭的腹部，成芦花朵状的绒毛，成片状的叫羽毛。
原木	原木是原条长向按尺寸、形状、质量的标准规定或特殊规定截成一定长度的木段，这个木段称为原木。
飘窗	飘窗垫，就是放在飘窗的台面上的垫子。
家居服	家居服指在家中休息或操持家务会客等，穿着的一种服装。
结婚	结婚jihn，法律上称为婚姻成立。
小脚	小脚，又名三寸金莲，特指缠足女子的脚，因其小而得名。
印花	印花，由政府出售，贴在契约凭证等上面，作为税款的一种特制印刷品。
户外	户外，是汉语词汇，汉语拼音为hwi，指室外露天处，与室内有区别户外活动也就是露天场所的活动。
年货	置办年货是中国寻常百姓家不可或缺的头等大事，包括吃的、穿的、戴的、用的、耍的、供的、送的拜年礼物、干黄山世界文化与自然双重遗产，世界地质公园，国家AAAAA级旅游景区，国家级风景名胜区，全国文明风景旅2018是2017与2019间的自然数，2018的倒数是12018，相反数是2018，2018的绝对。
塑料	PPSU是一种无定形的热性塑料，具有高度透明性、高水解稳定性。
电视柜	电视柜主要是用来摆放电视的.随着人民生活水平的提高,与电视相配套的电器设备相应出现，导致电视柜的用途摆件，就是摆放在公共区域、桌、柜或者橱里供人欣赏的东西，范围相当广泛。
玻璃杯	玻璃杯glass是指玻璃制成的杯子，通常由原材料高硼硅玻璃，经过600多度的高温烧制而成，它是新型的杯子，日用器皿，从古至今其主要功能都是用来饮酒或饮茶。
春夏	春夏，1992年12月5日出生于云南省昆明市，中国内地影视女演员、平面模特。
仿古	仿古，指模仿古器物或艺术品，也指模仿前人。
果汁	果冻是一种西方甜食，呈半固体状，由食用明胶加水、糖、果汁制成。
原装	所谓原装，就是指一件产品，或者事物，是原厂生产，并非由委外或其他授权的厂家联合组装而成的。
茶叶	姜茶是一种饮品，用茶叶少许，生姜几片去皮水煎，饭后饮服。
运动鞋	运动鞋是根据人们参加运动或旅游的特点设计制造的鞋子。
婴儿床	婴儿床是指给婴幼儿使用的床。
特价	特价，特别优惠的价格、特别低廉价格的简称。
透明	摆台就是摆在台面上的照片，它包括照片、相框、透明玻璃、衬板和支撑件，所谓台面，它包括桌面、床头柜、梳。
甜品	甜品，是一个很广的概念，大致分为甜点心和广式的糖水。
中老年	不同的文化圈对于老年有着不同的定义，由于生活质量的提高，生命周期变长，各年龄的分界线开始模糊，中老年貉子又名狸、土狗、土獾、毛狗、貉子，是哺乳纲、食肉目，犬科，貉属半冬眠，貉子皮的外形象狐，但比狐小，妈妈装指适合妈妈穿着的服装，妈妈装随着时代的发展、文明和进步，成为女装中不可缺少的一部分。
美式	美式咖啡机都是全自动，没有半自动产品，主要针对家用。
秋装	秋装，顾名思义就是秋季穿的服装。
嵌入式	ESAMEmbeddedSecureAccessModule嵌入式安全控制模块的实质为DIP或者SO全自动咖啡机指的是，只需按下按钮便可以制作出一杯咖啡的机器其实现了从咖啡豆磨粉到热水冲煮出咖啡的全过进口，是指向非居民购买生产或消费所需的原材料、产品、服务。
铸铁	铸铁主要由铁、碳和硅组成的合金的总称。
大码	大码女装又称胖人服饰，胖人服装，多尺寸女装，特大码女装等，就是针对体重超过标准身体重量的丰满女性朋友大衣Coat是一种常见的外套，衣长度至腰部及以下。
松紧	松紧，指松或紧的程度。
wifi	VITA是SONY新一代次时代掌上游戏机，支持wifi和3G联网，竞争目标是苹果iPodTouch以。
春秋	03是梦回春秋创作的网络小说，发表于晋江文学网。
手表	手表，或称为腕表，是指戴在手腕上，用以计时显示时间的仪器。
牛排	肉眼，一般指自然情况下的人类的眼睛，有时可以指代肉眼牛排。
仿真	仿真Simulation，即使用项目模型将特定于某一具体层次的不确定性转化为它们对目标的影响，该影响甜甜圈，又称多拿滋、唐纳滋，它是一种用面粉、白砂糖、奶油和鸡蛋混合之后再经过油炸的甜食。
阿迪达斯	三叶草adidasOriginals从1972年开始成为阿迪达斯的标志，当时所有阿迪达斯产品都使用这威尔史密斯WillSmith，美国演员、歌手，1968年9月25日出生于美国宾夕法尼亚州费城。
超大	上海，简称沪或申，是中国共产党的诞生地，中华人民共和国直辖市，国家中心城市，超大城市，沪杭甬大湾区核同城，指同一城市，往往能有效团结同一城市的人，使他们在生产、生活、交流的情感等方面更加贴近。
个性	盘发即把头发盘成发髻，盘发已经可以演绎出各种不同年龄、不同个性、不同气质女性的万千风情。
拉链	拉链zipper是依靠连续排列的链牙，使物品并合或分离的连接件，现大量用于服装、包袋、帐篷等。
毯子	毯子，拼音tnzi，出自麒麟罽辕门邂逅。
安卓	T1，是由深圳市联代科技有限公司研发生产的安卓智能手机。
polo	大众polo诞生于1975年，在其后的30年时间里，历经五代产品演变，总产量超过700万辆，并曾长期M16是美国军方给由阿玛莱特公司的AR15发展而来的步枪家族所指定的代号。
chic	荔枝学名LitchichinensisSonn.无患子科，荔枝属常绿乔木，高约10米。
工装裤	工装裤cargopants是一种宽松而有很多裤子口袋的裤子。
工具	钓鱼椅是钓鱼爱好者的钓鱼必备工具之一，真正体现钓鱼的休闲活动。
早教	早教，也叫早期教育，广义指从人出生到小学以前阶段的教育，狭义主要指上述阶段的早期学习。
手柄	topgrade;superiorquality基本解释质量好，手柄，一种电子游戏机的输入设备，通过操纵其按钮等，实现对电脑上模拟角色等的控制。
带盖	保温桶，俗称生财桶，是带盖水桶的一种。
落地灯	落地灯英文名为Floorlamp！通常分为上照式落地灯和直照式落地灯。
一体	一体，1.谓关系密切或协调一致，犹如一个整体。
立式	立式，读音是lsh，汉语词汇，解释为直立的、竖直的。
沙发垫	沙发垫是指直接铺在沙发上坐面上的垫子，主要用途是用来包裹保护沙发。
原味	原味是一种味道，指事物本来特有的味道没有经过人为添加的味道。
升降	升降桌在欧美国家大量使用升降桌。
蓝色	蓝色blue是一种颜色，它是红绿蓝光的三原色中的一元，在这三种原色中它的波长最短，为440475n纳外套，又称为大衣，是穿在最外的服装。
家用	家用是汉语词汇，出自管子权修，解释为家庭日常使用的。
毛巾	毛巾是一种清洁用品，特征为方形纯棉纺织品，使用方法为打湿后拧干擦拭皮肤，以达到去除污渍、清洁凉爽的效。
酒店	酒店又称为宾馆、旅馆、旅店、旅社、商旅、客店、客栈，台湾作饭店，港澳、马来西亚、新加坡等作酒店其基本小号使用五线谱高音谱表记谱。
设计师	设计师adesigner。
条纹	科技名词定义中文名称条纹英文名称striate;stria;striae复定义1壳面上的线条状突起，茶杯是盛茶水的用具，水从茶壶而来，倒进茶杯，之后给客人品尝茶水。
水晶	白酒杯是，一般为佳水晶白酒杯值得推荐原料采用无残留的高纯度二氧化硅烧制而成...历史学上通常指奴隶制时代。
周岁	青春指15周岁至20周岁的阶段。
街头	街球包括街头足球，街头篮球，大多数情况下是指街头篮球streetball。
脚裤	小脚裤是一种上松下紧的裤子，它的译名很多，也叫锥裤，宽泛的大类叫做修身长裤Slimfitpants。
夹克衫	只是经常出现的名词，在淘宝里面很盛行，就是大一点物品的意思damanamedescriptionme夹克衫是英文Jacket的译音。
木床	实木床是一种床，床的主要部件中装饰件、配件除外，其余采用实木锯材或实木板材等木质材料制成的床。
电竞	多彩科技集团是一家从事电竞外设和电脑外设周边产品专家级的研发、生产、销售的集团公司，旗下的深圳市多彩现货Actuals亦称实物physicals，指可供出货、储存和制造业使用的实物商品。
线控	线控机电行业特定短语。
西服	西服Westernstyleclothes又称西装，即西式上衣的一种形式。
1.5	长弓一般长5英尺1.5米左右，大致齐眉，个别的长达1.82米，比欧洲常见的4尺弓要长。
办公	办公是一个汉语词汇，拼音是bngng，意思是处理公事，处理公务。
棉质	一块棉质布料为主去在饭桌上的布...释义词目桌布拼音zhub定义桌布又称台布，英文名tablecloth为覆盖于台面、桌面上用以防污或增书桌，指供书写或阅读用的桌子，通常配有抽屉，分格和文件架。
新生儿	新生儿，拼音xnshngr，词义新生儿xnshngr，英文释义newbornbaby;neonate防水早已不再是一个新鲜的话题，不论是隧道、桥梁、堤坝、道路、建筑还是我们日常居住的房屋，防水都不容忽围巾在我国黄帝蚩尤的时代，是把那些获胜的兽皮，作为奖励品发给那些值得肯定的人的，也就是说，最初围巾这女孩，有两种意思，1.。
法国	法国欧莱雅集团是世界上最大的化妆品公司之一，创办于1907年。
书包	书包，是指用布、皮革等制成的袋子。
拼接	拼接，动词，汉语拼音为pnji，英文为puttogether，joint意思是接在一起。
挂表	挂表是汉语词语，读音为gabao，意思是怀表。
冬季	冬季是四季之一，秋春之间的季节。
新生	随着科技水平的快速发展，科技美容这一行业做为新型产业新生而出。
体恤	体恤，指替他人实际处境着想而怜悯、帮助。
护颈	护颈，顾名思义，就是用以保护颈部的围布。
坐垫	坐垫使用舒适并具有装饰作用形状多为方形、圆形和椭圆形。
日系	日系风格的搭配，是因为有了绚丽不羁的涂鸦，同样能呈现妩媚妖娆的满眼惊艳，它已是时尚界的一种混乱美学。
可爱	可爱是一个词语，在现代汉语中有两层含义一.令人敬爱的。
煎锅	电煎锅是一种采用复底焊接工艺，热效率高，使用寿命长，能够进行煎，烙的现代化炊具。
秋冬装	秋冬装，顾名思义，指秋冬天穿的服装。
立领	立领是正装衣服风格，是指领子穿着的时候是立起来的，而且没有办法翻下去。
徒步	徒步Tramp，是指有目的的在城市的郊区、农村或者山野间进行中长距离的走路锻炼，徒步是户外运动最为典手杖，亦名扶杖、拐杖、拐棍。
女友	女友通常指在一对情侣关系中，男方对拥有恋爱关系的女性一方的简称，即表意更为明确的另一个词女朋友的简称巧克力chocolate，原产中南美洲，其鼻祖是xocolatl，意为苦水。
靠背	床尾凳，是汉语词汇，解释为没有靠背的坐具。
插卡	插卡音箱一般是指目前市场上支持或者能够读取SD、TF等等这些内存处理器的音箱，与传统的电脑音箱，手机老人，指的是上年纪了的人或较老的人。
背景墙	背景墙，外文名Backgroundwall，是一种装饰于家庭客厅电视、沙发、玄关、卧室墙等的家庭装修指一年中交替出现的四个季节，即春季、夏季、秋季和冬季。
大衣	大衣Coat是一种常见的外套，衣长度至腰部及以下。
早餐	早餐饼是一种面试，主要材料有鸡蛋、面粉等，辅料有洋葱、胡萝卜、熏肉、盐、胡椒粉、橄榄油等。
座椅	座椅是一种有靠背、有的还有扶手的坐具。
秋冬季	尼克服Nickgarment是近年秋冬季流行于欧洲与北美各国的一款新型款式的高档皮草服饰时尚，简约，皮草是指利用动物的皮毛所制成的服装，具有保暖的作用，现在的皮草都较为美观并且价格较高也是不少消费者的新款，读音xnkun，汉语词语，指新的款式。
墙上	照片墙指在一面墙上挂上照片，组成不同的形状，表示主人风采的地方。
50	50五十，是49与51之间的自然数。
双排	双排扣大衣是一款运行于PC平台的休闲类游戏。
双层床	双层床是指上下双层的床。
少女	近年来，在广大年轻少女之间掀起一股狂热的猫耳朵热潮，而这股热潮，正是来自a02这个AZONA旗下的品多士炉，英文名Toaster，我国称为自动面包片烤炉、面包烘烤器，它是一种专门用于将切成片状面包重新烤面包机，即多士炉，英文名Toaster，是一种常用的厨房用品，主要用来烘烤面包片。
大气	钢在空气和水中容易生锈，而锌在大气中的腐蚀率仅为钢在大气中腐蚀率的115，镀锌钢板就是用微密的镀锌层EcoDrive光动能是西铁城的注册商标，意思是推动和维护生态环境。
木家具	实木家具是指使用实木制作的家具。
挂画	戏剧挂画是本戏梵王宫中的一折，梆子戏中常见的剧目，是蒲剧蒲州梆子的代表作。
原宿	原宿，是东京都涩谷区的一个地区，范围约为明治神宫、代代木公园、竹下通、表参道、国立代代木竞技场一带，潮流的定义就是流行趋势的动向，引申意思是社会变动或发展的趋势。
篮球	篮球basketball，是奥运会核心比赛项目，是以手为中心的对抗性体育运动。
批发	批发网成立于2008年6月，是一家为传统批发市场商铺和批发厂商提供网上服装批发。
马桶	马桶大小便用的有盖的桶，俗称马子。
礼品	礼品杯，用于礼品赠送给他人的杯子。
旅游	度假旅游是利用假日外出以度假和休闲为主要目的和内容的，进行令精神和身体放松的康体休闲方式。
泡面	方便面又称泡面、杯面食物、快熟面、速食面、即食面。
男式	只是经常出现的名词，在淘宝里面很盛行，就是大一点物品的意思damanamedescriptionme男式牛仔裤是一款装扮小游戏，游戏大小为744K。
背心	救生衣lifejacket又称救生背心，是一种救护生命的服装，设计类似背心，采用尼龙面料或氯丁橡胶N。
厕所	厕所、浴室、盥洗合称为卫生间，洗手间应该指盥洗部分，具有整理、梳洗功能，洗手间俗称厕所，泛指由人类建梳妆镜是连载在起点中文网的都市言情类小说，作者是未悟道的佛。
房间	房间是由兰纳德阿伯拉罕森执导，布丽拉尔森、雅各布特瑞布雷、威廉姆H梅西等主演的剧情片。
紧身	定义简述连裤袜又称袜裤、紧身袜、五骨袜或丝袜裤，是紧包从腰部到脚部躯体的服装，绝大多数连裤袜专为女性肤色是指人类皮肤表皮层因黑色素、原血红素、叶红素等色素沉着所反映出的皮肤颜色。
尖头	尖头，读音为jintu，汉语词语，意思是指尖锐的端部。
整装	娅丽达品牌是以裤装为核心主打产品、以上装为优势产品的系列化整装品牌，本着源自1995，专做女裤的专业增加厚度，指再事物原有的状态的情况下再使其增加一定的高度。
糖果	糖果是糖果糕点的一种，指以糖类为主要成份的一种小吃。
洗澡	浴池，指供洗澡的池塘。
整理	整理常用于表示去除不需要的东西。
地中海	地中海因介于亚、欧、非三大洲之间而得名。
夏季	西方人则普遍称夏至至秋分为夏季。
中国	quot;北极绒quot;属上海赛洋集团旗下品牌，诞生于1998年，是中国最早的保暖内衣龙头品牌之一蚊帐mosquitonet。
挂钟	挂钟最早是由塔钟演变而来，大约在16世纪欧洲出现庞大体积的塔钟建筑，限于当时的制造技术，钟表一般体积时钟是生活中常用的一种计时器，人们通过它来记录时间。
小号	小号使用五线谱高音谱表记谱。
青少年	青春痘是一种常见的皮肤病，俗名粉刺、青春痘、暗疮，医学上统称为痤疮，中医古代又称面疮、暗疮、粉刺、酒青春痘是毛囊皮脂腺单位的一种慢性炎症性皮肤病，好发于青少年,青春期后往往能自然减轻或痊愈。
茶杯	茶杯是盛茶水的用具，水从茶壶而来，倒进茶杯，之后给客人品尝茶水。
落地	落地，指婴儿出生，指物体的下端直达地面，物体落到地上或声音停止等意义。
坐便器	坐便器，属于建筑给排水材料领域的一种卫生器具。
水洗	摄影中在冲卷和放照片是显影后有一步水洗过程这里是讲把底片或相纸放在装满水的容器里洗掉上边的药水免得在地毯是用动物毛、植物麻、合成纤维等为原料，经过编织、裁剪等加工过程制造的一种高档地面装饰材料。
隔断	隔断隔断是指专门作为分隔室内空间的立面，应用更加灵活，如隔墙、隔断、活动展板、活动屏风、移动隔断、移东南亚SoutheastAsia位于亚洲东南部，包括中南半岛和马来群岛两大部分。
不粘锅	不粘锅即做饭不会粘锅底的锅，是因为锅底采用了不粘涂层，常见的、不粘性能最好的有特氟龙涂层和陶瓷涂层。
ins	民宿Minshuku，源自日本的民宿。
电源	推拉公司生产的最新机主要由主机电源、液压修理液压实验台工程机械维修热喷涂等业务。
四季	辣白菜朝鲜语kimchi是一种朝鲜半岛的风俗发酵美食，特点是辣，脆、酸、甜，色白带红，四季皆宜。
连体衣	爬爬服又叫连体衣，哈衣，爬装，适合02岁间的婴幼儿穿着，是连身的衣服，面料一般有全棉汗布的，摇粒绒的哈衣，又称连身衣、连体衣、爬服，还没这个概念的，也是一种新式服装。
吊灯	吊灯是指吊装在室内天花板上的高级装饰用照明灯。
潮牌	只是经常出现的名词，在淘宝里面很盛行，就是大一点物品的意思damanamedescriptionme潮牌，多指一些原创品牌有自己的设计，张扬设计师的独特思想品格、风格和生活态度，整体商品感觉被人认可为胖子，即对于体重过重或体形过于宽硕的人的俗称。
书架	书架，广义上是人们用来专门放书的器具。
茶具	饮茶离不开茶具，茶具指泡饮茶叶的专门器具，包括壶，碗，杯，盘，托等，古人讲究饮茶之道的另一个重要表现宜兴紫砂壶，始于明代正德年间。
毛绒玩具	毛绒玩具，也叫布绒玩具。
二合一	二合一是gwf小龙飞写的网络小说连载于起点中文网。
美国	极速Zoom是美国DC漫画旗下超级反派，初次登场于的闪电侠秘密档案与起源FlashSecretFil哄哄，读音hnghng，汉语词语，基本意思为嘈杂纷乱貌。
打底	打底衫就是可以直接穿在身上的，里面再穿件内衣比如文胸然后可以搭配任何贴身穿的衣服，一般全部叫打底衫。
架子	架子，指放东西的支撑物，支持藤本或其它植物的棚架，装模作样的自大神态或姿势。
七匹狼	福建七匹狼实业股份有限公司是一家以生产制造业为基础，涉及服装贸易、物流等诸多领域的大型公司。
饭盒	隔热是指在热量传递过程中，热量从温度较高空间向温度较低空间传递时由于传导介质的变化导致的单位空间温度饭盒是一种专门用来装饭菜的盒子，也称便当盒，大多用铝、不锈钢、塑料制成。
翻领	翻领lapel汉语词汇，指翻在底领外面的领面造型。
手环	手环是人类发展历史上的一种配饰，在不同时期不同场合对于不同的人物具有不同的意义。
古典	法语、英语ballet，是一种欧洲古典舞蹈，孕育于意大利文艺复兴时期芭蕾，欧洲古典舞蹈，由法语ballet音译而来。
插花	插花floarr，亦可称为插花艺术，就是把花插在瓶、盘、盆等容器里，而不是栽在这些容器中。
躺椅	躺椅，为清代出现的具有新样式与功能用途的家具之一，我国封建社会末期工艺与技艺不断提高，人们对生活质量洗头床又称为洗发床、冲头床等，属于理发店、美发店常见家具之一，用于客户坐式洗头或躺式洗头必备的理容器世纪宝贝Babyhood是世纪宝贝集团有限公司旗下知名婴童品牌，成立于2009年，致力于03岁婴幼儿。
多层	贴纸机广泛用于密度板、多层胶合板、细木工板、玻璃、亚克力、马赛克及各种平面板材表面的覆膜、压花、彩绘儿童玩具是指专供儿童游戏使用的物品。
灯饰	灯饰是家居的眼睛，家庭中如果没有灯具，就像人没有了眼睛，没有眼睛的家庭只能生活在黑暗中，所以灯在家庭吊灯是指吊装在室内天花板上的高级装饰用照明灯。
粗陶	粗陶就是用含沙量含铁量比较多的陶泥烧制的陶器。
耐热	耐热，heatresistance，是指在高温下具有高的抗氧性、抗蠕变性与强度持久的特性。
饼干	饼干的词源是烤过两次的面包，是从法语的bis再来一次和cuit烤中由来的。
中年	本书主要面向关注自我的中年女性。
卧室家具	卧室家具，指摆放于卧室的家具统称，卧室家具包括但不限于床、床垫、衣柜、梳妆台和床头柜，以及床上用品等。
家纺	博洋家纺有限公司成立于1995年，是宁波博洋控股集团有限公司的下属子公司之一，博洋家纺在国内最早致力。
口袋	口袋，著名掌机游戏PocketMonster口袋妖怪的汉译缩写。
电脑	台湾华硕电脑股份有限公司是目前全球第一大主板生产商、全球第三大显卡生产商，同时也是全球领先的3C解决。
手推车	手推车wheelbarrow;barrow;handtruck是以人力推、拉的搬运车辆，它是一切车辆四轮，拼音是sln，是一个汉语词汇，释义为通达四方。
羽绒	羽绒被的填充物主要是羽绒，羽绒是长在鹅、鸭的腹部，成芦花朵状的绒毛，成片状的叫羽毛。
男青年	广播剧网络配音CV，广播剧剧团星之声中文配音组成员，声音特点温和男青年音，属性正直、略呆萌、有时略二。
吸管	吸管，英文straw，或称饮管，是一条圆柱状，中空的塑胶制品，其主要功用是用来饮用杯子中饮料，也有用。
浴室柜	浴室柜是浴室间放物品的柜子，其面材可分为天然石材、玉石、人造石材、防火板、烤漆、玻璃、金属和实木等。
牛津纺	牛津纺是一种衬衫面料，手感柔软，组织结构是平纹变化组织或方平组织。
乳胶	乳胶latex泛指聚合物微粒分散于水中形成的胶体乳液。
迪卡侬	迪卡侬来自于法国，是体育用品零售商，由米歇尔雷勒克于1976年创立，第一家店开在法国里尔附近的小村庄营地是汉语词汇，拼音yngd，意思是军队扎营的地方。
办公桌	办公桌是指日常生活工作和社会活动中为工作方便而配备的桌子。
60	6021是介于6020与6022之间的自然数。
爸爸	爸爸，对父亲的一种称呼，多用于口语。
机械表	手动机械表是靠手动上紧发条来驱动的手表，通常由转动表冠，来上紧表内的发条，发条系统释放出动能来驱动手手表，或称为腕表，是指戴在手腕上、用以计时显示时间的仪器。
黑白	芝麻酥，是用黄油、低筋面粉、糖粉、全蛋、黑白芝麻为材料烤制的一种甜品点心，是常见的传统特色小吃。
壁饰	壁饰wallornamentation是指装簧于墙壁上的饰物。
线衣	线衣是由各种服用纤维组成的纱线，通过手工或者针织机械织成的服装。
大容量	移动硬盘MobileHarddisk顾名思义是以硬盘为存储介质，计算机之间交换大容量数据，强调便携性串行接口简称串口，也称串行通信接口或串行通讯接口通常指COM接口，是采用串行通信方式的扩展接口。
丝绒	丝绒是割绒丝织物的统称。
现代	现代裤类名称，又称筒裤。
亚麻	亚麻学名LinumusitatissimumL.是一年生草本植物，可分成纤维用亚麻、油用亚麻和油纤兼新款，读音xnkun，汉语词语，指新的款式。
夹心	夹心是一个汉语词汇，意思是夹馅。
厨房用品	厨房用品种类繁多，生活必备，且不能缺少。
车用	控制是银都机构有限公司、华谊兄弟传媒有限公司联合出品的一部悬疑电影，由毕国智执导，吴彦祖、冯德伦监制哈曼卡顿HarmanKardon是哈曼国际工业NYSEHAR的一个部门，专门生产制造家用与车用音响，智能，是智力和能力的总称，中国古代思想家一般把智与能看做是两个相对独立的概念。
改装	改装gizhung，词语，有改变设备原来的结构、装置。
简约	布艺床，采用简约的设计风格，强调健康舒适的设计理念，形成既保留温馨又充满时尚节奏的独特产品。
大号	大号或低音大号是一种管乐、管弦乐队中音域最低的铜管乐器，一八三五年德国人魏普莱西特发明。
超薄	液晶显示器，为平面超薄的显示设备，它由一定数量的彩色或黑白像素组成，放置于光源或者反射面前方。
喂奶	喂奶，一个动词，意为成年雌性哺乳动物给年幼的动物喂食。
食品	福建雅客食品有限公司创办于1993年10月，坐落于最具经济活力的海峡西岸经济区闽南金三角晋江市，是目果汁是以水果为原料经过物理方法如压榨、离心、萃取等得到的汁液产品，一般是指纯果汁或100果汁。
桌椅	桌椅是指专供就餐用的椅子，是餐厅家具的一种。
榻榻米	其实追溯榻榻米的来源并非日本，而是中国唐朝时期。
篮球鞋	篮球鞋即SNEAKER，同时也将球鞋爱好者融入到SNEAKER一词中，使得SNEAKER有更宽泛的定。
直筒	直筒牛仔裤直筒牛仔裤是牛仔裤的一种，其特点是从膝盖以下的部分是直筒。
手绘	广义的手绘是从事建筑、服饰陈列设计、橱窗设计、家居软装设计、空间花艺设计、美术、园林、环艺、摄影、工业设计水杯汉语拼音是shubi，英语名是cup。
自制	自制是一个汉字词语，拼音是zzh，解释为指自行制订、自己制造、克制自己，出自典故汉书王吉传，同义词有西饼是指来自西方国家的西式点心与糕饼。
针织	冰丝是一种针织服饰用面料，它是由70粘胶长丝和30锦纶丝采用交并加捻而成。
轻奢	IMIS爱美丽诞生于2005年，是爱慕集团旗下定位为都市、活力的平价轻奢内衣品牌。
大礼包	海鲜大礼包逢年过节，送礼一直是中国的传统。
华菲	可口香烟是三十年代华菲烟公司所生产的。
即食	即食，指可以立即食用的食物。
胖子	胖子，即对于体重过重或体形过于宽硕的人的俗称。
乞丐	乞丐beggar就是以乞讨为生的人统称为乞丐，也叫叫花子或作要饭的。
汽车	我国国家最新标准汽车和挂车类型的术语和定义GBT373012001中对汽车有如下定义由动力驱动，具有511，指的是强氧化溶液，在半导体制造中常用于清洗外延片。
化妆	一种化妆用品，用于眼部装饰，有黑色等多种颜色，防水、速干、超持久，能无限释放大眼魔力，不晕染，但不太防水早已不再是一个新鲜的话题，不论是隧道、桥梁、堤坝、道路、建筑还是我们日常居住的房屋，防水都不容忽初学者Beginners又名爱的初学者、基爸爱留情、新手人生，是美国焦点公司于2011年出品的爱情、。
棒球	棒球运动是一种以棒打球为主要特点，集体性、对抗性很强的球类运动项目。
儿童床	儿童床又名摇篮床，指儿童使用的床，特点是安全实用，儿童床有传统的、经典的，现代的和更流行的。
全包	全包是装修方式中的一种，全包和半包相比，装修方在装修中会负责购买更多的建材。
太平	太平鸟学名Bombycillagarrulus为鸟纲太平鸟科的鸟类。
圣诞节	圣诞节Christmas，这个名称是基督弥撒的缩写。
100	nbsp;概述100一百是99与101之间的自然数。
旗舰店	旗舰店一词来自欧美大城市的品牌中心店的名称，其实就是城市中心店或地区中心店，一般是某商家或某品牌在某高跟鞋是指鞋跟高于普通鞋的一种鞋，使穿此鞋人的脚跟明显比脚趾高。
充电	充电是给蓄电池等设备补充电量的过程。
飞利浦	飞利浦，1891年成立于荷兰，主要生产照明、家庭电器、医疗系统方面的产品。
500g	用料材料用量中筋面粉500g水235g盐2g做法1.全部材料放入面包机，和面程序15分钟，程序结束后家用是汉语词汇，出自管子权修，解释为家庭日常使用的。
四件套	四件套分类纯棉布按织法一般可分为中纹布，斜纹布，平纹布，缎纹布和提花布。
马克	潮男即都会美型男Metrosexual，亦称都市美型男，按照英国记者马克辛普森MarkSimpson潮牌，多指一些原创品牌有自己的设计，张扬设计师的独特思想品格、风格和生活态度，整体商品感觉被人认可为原创是独立完成的创作。
职业	康复是指综合地、协调地应用医学的、教育的、社会的、职业的各种方法，使病、伤、残者包括先天性残已经丧失升降，指登高与趋下的意思，上前与后退升或进与黜退。
旅行	旅行，指远行。
营养	饮品，指经加工制成的适于供人或牲畜饮用的液体，尤指用来解渴、提供营养或提神的液体。
储物箱	储物箱通常也叫整理箱、储物盒、整理盒、收纳箱。
重低音	重低音其实是电子音乐里，低音音乐的一个叫法。
厚底	厚底就是一种简单的含义。
床上	床上是立方网推出的一款睡前导读应用，现已推出Android4.8.0版。
小伙	小伙，多用于汉语口语，中国北方指小伙子。
水壶	碧然德BRITA，全球领先的饮用水优化品牌，在许多国家它已经成为滤水壶的代名词。
男士	金利来品牌起源于中国香港，由著名的爱国人士、慈善家曾宪梓博士创立，其系列产品及经营权使用商品包括男士男鞋字面上理解为男式鞋。
客厅	客厅灯顾名思义就是在客厅的灯。
定制	定制一词起源于萨维尔街，意思是为个别客户量身剪裁。
真空	枣片枣片是将红枣深加工制成枣片，高压打浆，真空浓缩，外包糯米纸。
口红	口红是彩妆中重要的化妆品之一。
纸盒	抽纸盒在外国叫tissuebox，是一种主要盛放卫生纸、纸巾等的盒子，适用于各种场合。
加大	加大码是林子祥演唱的歌曲，由林振强作词，rodneytemperton作曲，收录在专辑千亿个夜晚中。
布洛克	布洛克，女，乌克兰籍田径女运动员。
男子	拼音nnsh基本解释man对成年男子的尊称。
刺绣	刺绣是针线在织物上绣制的各种装饰图案的总称。
石英表	石英表是腕表种类之一，英文是quartzwatch。
免烫	免烫服装及纺织品中的甲醛含量免烫服装，其定义为经家庭洗涤后只需轻微熨烫或无需熨烫即可恢复到穿着或使用休闲杂志是杭州日报报业集团旗下的一媒体，杂志以关注产业发展，引领休闲生活为办刊理念，全程记录中国休闲。
书柜	书柜是书房家具中的主要家具之一，即专门用来存放书籍、报刊、杂志等书物的柜子。
双人	双人,正如字面上的意思两个人,也就是于自己配合时对自己的称呼。
女装	衣香丽影品牌诞生于2000年6月，主要从事中高档女装的设计、生产、销售、服务，以突出女性时装青春亮丽。
定做	定做是汉语词汇，拼音dngzu，解释为一定做成。
抽绳	抽绳，各种服装、包包等产品中运用的一种绳子，可调整大小、宽窄，是时尚产品中的一种设计元素。
呢大衣	毛呢大衣是2014年发布的一款换装类软件，软件大小为1MB。
马甲	马夹同马甲，意思主要有马的护身甲，干贝、江珧肉柱，方言背心，清八旗制的兵丁。
成人	成人是指成年的人，即是已经完全发育成熟的人，与儿童相对。
遮光	遮光是连载于起点中文网的网络小说，作者是长刀明月。
童装	儿童服装简称童装，指适合儿童穿着的服装。
清新	清新，词语，拼音qngxn，指清爽而新鲜，中国古典诗词有相关语言风格道家哲学思想。
睡衣	睡衣早已成为西方式生活的象征。
电脑主机	OTB功能中文意思就是一键备份在需要备份资料的电脑主机中安装专门的驱动软件，运行一键备份软件并设置好饰品盒用以放置、收纳饰品的小盒子，做工精细，方便携带，深受女性喜爱。
旋转	冲击钻依靠旋转和冲击来工作。
棉麻	棉麻是指棉和麻为原材料的纺织品，棉和麻都是温带的植物生长出来的分别有棉花和芘麻的种子部分采下来，经过小西装又名小西服，一般简单分为女士小西装和男士小西装，其中女士小西装是春秋最热门的单品之一，小西装没亚麻学名LinumusitatissimumL.是一年生草本植物，可分成纤维用亚麻、油用亚麻和油纤兼。
卫裤	卫裤通常是指由棉或涤纶这两种面料制作的运动裤。
男装	只是经常出现的名词，在淘宝里面很盛行，就是大一点物品的意思damanamedescriptionme男装，是指男性穿于人体起保护和装饰作用的服饰制品。
聚拢	聚拢文胸是一种功能性文胸，正如字面意思，可以将胸部由两侧向中间聚拢，这类文胸通常是上薄下厚模杯，有利。
鼠标	鼠标是一种很常用的电脑输入设备，分有线和无线两种。
运动套装	运动套装是一系列的运动服装。
绣花	2.绣花用的彩色丝线文艺Literatureandart文学和艺术，有时指文学或表演艺术，是人们对生活的提炼，升华和表达。
沙发	沙发是个外来词，根据英语单词sofa音译而来。
全套	全套指全部有关的单元或设备、部件。
回力	上海回力鞋业有限公司是上海华谊集团公司的全资子公司，专业从事回力牌运动鞋及各类鞋产品的研发、制造和销。
钟表	罗西尼系香港上市公司冠城钟表珠宝集团有限公司HK.00256旗下全国知名企业，中国领先腕表品牌。
窗帘	纱帘，英文名sheer，顾名思义纱质窗帘，通常是透明或者是半透明的纱。
禅意	禅意是一个汉语词汇，拼音是chny。
皮夹克	皮夹克是采用动物皮，如猪皮、牛皮、羊皮、蛇皮、鱼皮等动物皮，经过特定工艺加工成的皮革做成的衣服，由于外套，又称为大衣，是穿在最外的服装。
格子	格子就是将网站首页划分成若干小格子放置别人的图片，或者出售，你买下来后可以在上面放上广告或者其他信息a型，能辨别事情的好坏、条理分明。
红色	红色，是以通过能量来激发观察者的可见光谱中长波末端的颜色，波长大约为610到750纳米，类似于新鲜血。
珐琅	珐琅，又称佛郎法蓝，其实又称景泰蓝，是一外来语的音译词。
滋润	润肤，汉语词语，读音是rnf，释义为滋润皮肤。
李宁	李宁，壮族，男，生于1963年3月10日，奥运冠军，原中国著名体操队运动员，家乡广西壮族自治区来宾市从空中用炸弹、导弹、火炮和火箭等对敌地面、水上目标进行的袭击。
清洁	清洁是由奥利维耶阿萨亚斯执导，张曼玉、尼克诺尔蒂主演的剧情片，于2004年9月1日在法国上映。
公主	背景设定王子和公主最后幸福地在一起了，这样的童话故事的结局永远是人们的最爱，这位小公主也和她的白马王夏凉被是夏天盖的薄被，其主要特性有透气性好，渗水性好，一般都不用套被罩，可直接水洗，夏凉被有着透气性韩国代购是指通过相关平台或者相关的个人代购韩国商品，各欧美时尚大牌都相当的重视亚洲市场。
床品	床品是家纺的重要组成部分，按照中国家纺协会的分类，包括床品类，窗帘类，洗漱厨房纺织品类，家具类纺织类套件是一款电脑软件，软件大小为1.9MB。
余文乐	闺蜜由知名香港女导演黄真真执导，陈意涵、薛凯琪、杨子姗、余文乐、钟汉良、吴建豪等众多明星主演，是一部银珠学名Peltophorumtonkinense是豆科盾柱木属的植物。
华为	华为技术有限公司简称华为是中国一家从事信息与通信解决方案的供应商，总部位于广东省深圳市。
男裤	最早的男裤应该是夏娃身穿得那套衣服吧，随着时间的推移，男裤的类型也丰富多彩，今天的主要流行的裤子也就。
男女	男女中的一方中请求对方与自己结婚。
卫浴	卫浴按字面意思就是卫生、洗浴，卫浴俗称主要用于洗澡的卫生间，是供居住者便溺、洗浴、盥洗等日常卫生活动脚垫主要是由于角质层老化，脚部经络血液循环不畅、皮肤长期受挤压或摩擦皮下水分与功能失衡而导致的角质增门垫是一种能有效地在入口处刮除泥尘和水份，保持室内地面整洁的产品。
文胸	抹胸式文胸给人的第一眼印象，就好比在胸口用丝布进行缠裹。
功夫	功夫茶盘指泡饮专用茶托，从材质上来分可以分为木质，石质，陶瓷，是古人讲究饮茶之道的另一个重要表现，是公道杯，古代汉族饮酒用瓷制品。
罐装	罐装是一种承装物品的形式。
盆栽	盆栽植物，表达山水景色的盆栽。
手机	拍照手机集手机和数码相机的功能于一体，它的方便之处在于便携性强，灵活方便，用户可以随时随地用它来进行。
主卧	主卧区别于次卧，是房屋主人的卧室。
家居	家居拼音jij指的是家庭装修、家具配置、电器摆放等一系列和居室有关的甚至包括地理位置家居风水都属于家桌面英文Desktop，是计算机用语。
折叠	折叠，读音为zhdi，指的是一份词语。
骆驼	骆驼，头较小，颈粗长，弯曲如鹅颈。
皮衣	皮衣是采用动物皮经过特定工艺加工成的皮革做成的衣服，主要作用是防寒，皮衣采用的制作原料有牛皮、羊皮、短款，读作dunkun，汉字词语，指结账时现金的数额少于账面的数额。
烧烤	烧烤Grill，Barbecue，可能是人类最原始的烹调方式，是以燃料加热和干燥空气，并把食物放置于烘焙原料主要分为化学膨松、蜂蜜干粉、塔塔粉、蛋糕油、面粉。
经济型	氙气灯HighintensityDischarge是指内部充满包括氙气在内的惰性气体混合体，没有卤素奔奔是一款经济型的小轿车，是中国长安汽车集团旗下的长安汽车历经3年时间，由上百名中外专家和技术人员设透镜是用透明物质制成的表面为球面一部分的光学元件，镜头是由几片透镜组成的，有塑胶透镜plastic和氙气是惰性气体中原子序数较大的元素也就是较重的元素，原子半径较大。
洋气	洋气，作形容词时指富有西洋的风格，也有指西方的文化。
复古	复古与怀旧，有时候很难区分。
全自动	全自动是指机械装置和产品生产、加工操作的全面自动化。
秋季	秋季是春夏秋冬四季之一。
西装	小西装又名小西服，一般简单分为女士小西装和男士小西装，其中女士小西装是春秋最热门的单品之一，小西装没亚麻学名LinumusitatissimumL.是一年生草本植物，可分成纤维用亚麻、油用亚麻和油纤兼。
餐桌	大理石餐桌大理石餐桌分为天然大理石餐桌和人造大理石餐桌。
茶壶	茶壶英文teapot，是一种泡茶和斟茶用的带嘴器皿。
吸水	事物的各部分互相关连协调而不可分，就像花泥也叫花泉或吸水海绵，是用酚醛塑料发泡制成的一种插花用品。
书房	书房，又称家庭工作室，是作为阅读、书写以及业余学习、研究、工作的空间。
羊绒	羊绒Cashmere是生长在山羊外表皮层，掩在山羊粗毛根部的一层薄薄的细绒，入冬寒冷时长出，抵御风寒帕洛Palo，男，出生于1979年8月8日，身高175厘米，74公斤，足球运动员，前卫，科科拉俱乐部反季，网络小说，作者方镜，连载于晋江文学城。
乡村	乡村是指乡村地区人类各种形式的居住场所即村落或乡村聚落，乡村一般风景宜人，空气清新，较适合人群居住，书台是一个汉语词汇，拼音是shti，解释是读书的处所。
腕表	西铁城是全球知名腕表品牌，以为全世界全体公民提供高档次的产品和高水准的服务为使命，希望通过为市民所喜EcoDrive光动能是西铁城的注册商标，意思是推动和维护生态环境。
战靴	足球鞋在足球明星们的脚下就称其为战靴。
居家	居家指所有和家庭生活相关的物品。
皮鞋	皮鞋leathershoe是指以天然皮革为鞋面，以皮革或橡胶、塑料、PU发泡、PVC等为鞋底，经缝绱。
13	14，是第十四个阿拉伯数字，也是介于13到15的自然数。
女生	百合是ACGN领域的概念，又称GirlsloveGL，指女生之间纯洁的爱慕关系代指女性间的恋爱，但又。
西餐	西餐这个词是由于它特定的地理位置所决定的。
羊毛	羊毛大衣是一款休闲益智游戏。
耳麦	耳麦，拼音rmi。
调味	电子商务术语，通常指电子商务从业工作者发表、分享的一些关于网络推广、网络营销工作知识经验和工作方法的开洋，是我国南方的方言，指的是腌制晒干后的虾仁干，用在烹饪中，起到提鲜调味的作用。
黑胡桃	黑胡桃JuglansNigra.，又名黑核桃，生长良好的胡桃木平均高度2030m，直径1m1.5m，实木餐边柜实木餐边柜是指放在餐桌旁边，用来储存食物或餐具的实木木质小柜子。
沙滩	高靿雨鞋的筒高泛指所有遮雨的用具，包括有雨衣、雨鞋、雨伞、帐篷、纳米雨衣伞、沙滩伞、防水裤、空调罩等。
环保	铜氨丝是从纯天然植物纤维中提炼出的一种可自然降解的全新绿色环保再生纤维素纤维,不污染环境，是赶超世界写意vividexpressionandboldoutline艺术创作术语。
嘻哈	嘻哈hiphop是一种诞生于美国贫民区街头的一种文化形式，一般的说法认为它诞生于美国纽约布朗克斯。
瑜伽	瑜伽铺巾是一种可以铺在与PVC瑜伽垫配套使用的，在上面做瑜伽，就可以减少和瑜伽垫的接触，让瑜伽垫持久。
运动服	运动服是指专用于体育运动竞赛的服装。
音响	音响指除了人的语言、音乐之外的其他声响，包括自然环境的声响、动物的声音、机器工具的音响、人的动作发出Sonos搜诺思成立于2002年，总部位于美国加利福尼亚州圣巴巴拉市，主要经营一体化无线智能音响、智SUB是一种图形格式字幕，由idx和sub文件组成，有时也能看到ifo文件，不过这个现在已经不怎么用。
儿童房	儿童房是孩子的卧室、起居室和游戏空间，应增添有利于孩子观察、思考、游戏的成分。
用品	一种穿在脚上的服饰用品。
训练	护掌，指的是用于保护人们手腕和掌部的护具，不仅被用于体育运动中，各种风湿、类风湿关节炎的患者、上年纪新歌训练完全由刘若英作曲作词并演唱的，该作品将其才女的风采展露无遗。
靠垫	靠垫是卧室内不可缺少的织物制品，它使用舒适并具有其它物品不可替代的装饰作用。
冬装	冬装，顾名思义就是冬天穿的服装。
骨瓷	骨瓷是于1794年由英国人发明的。
小学生	小学生，指正在小学上学的学生，亦指某类成年人的想法和思维方式与同龄人相差甚远甚至背道而驰，对事物的认。
欧式	欧式家具是欧式风格装修的家具，以意大利、法国、英国和西班牙风格的家具为主要代表。
书桌	书桌，指供书写或阅读用的桌子，通常配有抽屉，分格和文件架。
笔记本	作词辻本健司山口教仁作曲花沢耕太编曲小林哲ChicagoPoodle...台式机，是一种独立相分离的计算机，完完全全跟其它部件无联系，相对于笔记本和上网本体积较大，主机、显示。
鸭绒	鹅绒被是羽绒被的一种，真正的羽绒被鹅绒、鸭绒等是被子中的上品。
毛衫	毛衫即用毛纱或毛型化纤纱编织成的针织上衣，又称羊毛衫。
女包	女包，这个名词是箱包的性别分类衍生词。
保温杯	保温杯Vacuumcup一般是由陶瓷或不锈钢加上真空层作成的盛水的容器，顶部有盖，密封严实，真空绝热便携binxi，汉语词语，释义为方便随身携带。
