新款	新款，读音xīn kuǎn，汉语词语，指新的款式。
韩版	该词条最初来源于服装。由于服装的版型有很多种叫法，有款式版，如修身版；有产地版，如欧版，韩版；还有原厂版，仿版等等。慢慢的，无论是韩国产的，或者韩国设计，甚至有在韩国销售的都被叫韩版服装。由于服装行业的普及性，大家开始把“韩版”扩充到其他各个地方，韩国电视剧，韩国电影，韩国着装，韩国发型，总的来说就是一切朝鲜民族传统文化与当代韩国社会文化风格结合的产物，我们身边还有很多很韩的人，谈吐或者表情。呵呵，听到看到的时候，千万不要惊讶，一个词打发吧——“韩版”~
男士	拼音：nán shì基本解释[man] 对13-29岁的青年男的尊称。有人认为18-65岁。多用于白领阶层。在英文中，对男士称呼为mister(Mr.)先生，也可以称呼sir，但是sir可以单独使用。女士就被称为小姐。
外套	外套，又称为大衣，是穿在最外的服装。外套的体积一般比较大，长衣袖，在穿着时可覆盖上身的其他衣服。外套前端有钮扣或者拉链以便穿着。外套一般用作保暖或抵挡雨水的用途。
休闲	休闲是指在非劳动及非工作时间内以各种“玩”的方式求得身心的调节与放松，达到生命保健、体能恢复、身心愉悦的目的的一种业余生活。科学文明的休闲方式，可以有效地促进能量的储蓄和释放，它包括对智能、体能的调节和生理、心理机能的锻炼，休闲是一种心灵的体验。以时间观点区分，一天24小时，减去生理时间(吃喝拉撒睡)和工作时间，其馀剩下的时间称为闲暇，闲暇时间所从事的活动，可称之为休闲
加厚	增加厚度，指再事物原有的状态的情况下再使其增加一定的高度。
简约	简约是一个汉语词汇，读音为jiǎn yuē，是指简略；不详细；简省。反义词是繁复、烦琐。《后汉书·马援传》等均有相关记载。
家用	家用是汉语词汇，出自《管子·权修》，解释为家庭日常使用的。
秋冬	百度百科是一部内容开放、自由的网络百科全书，旨在创造一个涵盖所有领域知识，服务所有互联网用户的中文知识性百科全书。在这里你可以参与词条编辑，分享贡献你的
套装	套装，指经精心设计，有上下衣裤配套或衣裙配套，或外衣和衬衫配套。有二件套，也有加背心成三件套。通常由同色同料或造型格调一致的衣、裤、裙等相配而成。其式样变化主要在上衣，一般以上衣的款式命名或区分品种。凡配套服装过去大多用同色同料裁制。但近年来也有用不是同色同料裁制的。但套装之间造型风格要求基本一致，配色协调，给人的印象是整齐、和谐、统一。在职业场所多选用这种穿着方式。
儿童	国际《儿童权利公约》界定儿童是指18岁以下的任何人。1991年12月29日第七届全国人民代表大会常务委员会第23次会议批准了《儿童权利公约》，并与各人民团体、国际组织、新闻媒体以及个人共同努力，把本公约规定的义务从单纯意向角度上的宣言转变成为改善所有中国儿童的生活的具体行动方案。《儿童权利公约》于1992年4月1日开始在中国正式生效。《儿童权利公约》由联合国1989年11月20日大会通过。是有史以来最为广泛认可的国际公约。
修身	修身，是指修养身心，修身的具体行为表现日常生活中就是择善而从，博学于文，并约之以礼。修身并不是一蹴而就的事，并不是看了些圣贤书就成为甚至超越圣人了。至于那些无助于个人陶冶情操、慷慨意志的杂学，不但无益于修身，还会让人自高自大，自认为无所不知，夸夸其谈。也就是说一个人即便学了再多的学科，看了再多的书，却没有办法约束自己的言行以符合礼仪的规范，使自己的身心受益，帮助他人成就善道，那所学则无非是“水月道场，梦中佛事”。修身的本质是一个长期与自己的恶习和薄弱意志作斗争的过程，时时检束自己的身心言行，用诚心、仁爱、谦卑的情操来祛除掉思想中的杂质，对治那些令我们轻浮、骄傲、自大、邪僻的外因、内因。修身最切实的办法就是择善而交，通过善友相互勉励来增长德行，培养志趣，用最朴实无华的态度切磋关于仁爱的学问。一定要远避世俗的虚谈，那些好卖弄学问的、巧言乱德的、文过饰非的，还有诸如攀比、争竞、夸耀、淫词、妄语、
宝宝	宝宝是对小孩儿的亲昵称呼。是爸妈或家人对婴儿或幼儿的昵称。古时候，父母有了孩子之后都是如获珍宝。在父母眼里，孩子都是宝贝。
长袖	长袖是一个汉字词语，意思是长的衣袖。
复古	复古与怀旧，有时候很难区分。怀旧是一种心情，复古是一种元素，要复古是一种态度。也有人总把传统讲成复古，传承与复兴是有区别的。
创意	create new meanings 创意是创造意识或创新意识的简称，亦作“剙意”。它是指对现实存在事物的理解以及认知，所衍生出的一种新的抽象思维和行为潜能。汉王充 《论衡·超奇》：“ 孔子得史记以作《春秋》，及其立义创意，褒贬赏诛，不复因史记者，眇思自出於胸中也。” 宋 程大昌 《演繁露·纳粟拜爵》：“ 秦始皇四年，令民纳粟千石，拜爵一级，按此即 鼂错 之所祖效，非 错 剙意也。” 王国维 《人间词话》三三：“ 美成 深远之致不及 欧 秦 ，唯言情体物，穷极工巧，故不失为第一流之作者。但恨创调之才多，创意之才少耳。” 郭沫若 《鼎》：“文学家在自己的作品的创意和风格上，应该充分地表现出自己的个性。”创意是一种通过创新思维意识，从而进一步挖掘和激活资源组合方式进而提升资源价值的方法。
正品	正品，汉语词汇，读音zhèng pǐn，指某个品牌原创出产的产品，对应词汇是假货、次品。正品也有以合格品、一等品、优等品表示的。 与副品对称。
加绒	百度百科是一部内容开放、自由的网络百科全书，旨在创造一个涵盖所有领域知识，服务所有互联网用户的中文知识性百科全书。在这里你可以参与词条编辑，分享贡献你的
时尚	“时尚”一词已是这个世界的潮流代言词，英文为fashion，几乎是经常挂在某些人的嘴边，频繁出现在报刊媒体上。很多人对时尚的理解都不同，有人认为时尚即是简单，与其奢华浪费，不如朴素节俭；有时时尚只是为了标新立异；给人焕然一新拥有时尚王风范的感觉，现实中很多与时尚不同步的人被指为老土、落伍；所谓时尚，是时与尚的结合体。所谓时，乃时间，时下，即在一个时间段内；尚，则有崇尚，高尚，高品位，领先。时尚在这个时代而言的，不只是为了修饰，而已经演化成了一种追求真善美的意识。
保暖	保暖：一种取暖的手段保暖：dc漫画角色
客厅	客厅（Living room）也叫起居室，是主人与客人会面的地方，也是房子的门面。客厅的摆设、颜色都能反映主人的性格、特点、眼光、个性等。客厅宜用浅色，让客人有耳目一新的感觉，使来宾消除一天奔波的疲劳。
纯棉	纯棉织物是以棉花为原料，通过织机，由经纬纱纵横沉浮相互交织而成的纺织品。目前按照实际加工的棉花来源又区分为原生棉织物和再生棉织物。① 本色白布：普通布面、细布、粗布、帆布、斜纹坯布、原色布。 ② 色布：有硫化蓝布、硫化墨布、士林蓝布、士林灰布、色府绸、各色卡叽、各色华呢。 ③ 花布：是印染上各种各样颜色和图案的布。如：平纹印花布、印花斜纹布、印花哔叽、印花直贡。 ④ 色织布：它是把纱或线先经过染色，后在机器上织成的布如条格布、被单布、绒布、线呢、装饰布等。
实木	百度百科是一部内容开放、自由的网络百科全书，旨在创造一个涵盖所有领域知识，服务所有互联网用户的中文知识性百科全书。在这里你可以参与词条编辑，分享贡献你的
冬季	冬季是四季之一，秋春之间的季节。天文学上认为是从12月至3月，中国习惯指立冬到立春的三个月时间，也指农历“十、十一（冬）、十二（腊）月”一共三个月。在南北半球所处的时间不同。按气象意义划分，在南半球温带及寒带，冬季在6、7、8月份（也可以按星座标准说是5月21日~8月22日），在北半球温带及寒带，冬季在12、1、2月份（也可以按星座标准说是11月21日~2月18日）。按节气意义划分，冬季从立冬开始，到立春结束，西方人则普遍称冬至至春分为冬季。 从气候学上讲，平均气温连续5天低于10℃算作冬季。
宽松	宽松，汉语词汇。指宽绰；不拥挤；富裕。如：日子过好了，手头宽松了。注音： kuān sōng
中长款	百度百科是一部内容开放、自由的网络百科全书，旨在创造一个涵盖所有领域知识，服务所有互联网用户的中文知识性百科全书。在这里你可以参与词条编辑，分享贡献你的
婴儿	婴儿是指小于1周岁的儿童。婴儿在这个阶段生长发育得特别迅速，是人一生中生长发育最旺盛的阶段，体重大约为9000～10000克。婴儿足月出生时已具有较好的吸吮吞咽功能，颊部有坚厚的脂肪垫，有助于吸吮活动，早产儿则较差。吸吮动作是复杂的天性反射，严重疾病可影响这一反射，使吸吮变得弱而无力。
欧式	百度百科是一部内容开放、自由的网络百科全书，旨在创造一个涵盖所有领域知识，服务所有互联网用户的中文知识性百科全书。在这里你可以参与词条编辑，分享贡献你的
女童	泛指2-8岁的女性
包邮	包邮简单的讲即包邮的商品的价格加邮费，拍下后不用补邮费差价。尤其是在现在的电子商务平台都会以包邮来吸引吸引客户前来购买。商家承担运费。有可能是先出运费，也有可能是报销。例如退货如果包邮就是报销。2019年7月9日报道，低价包邮商品在各大电商平台都很常见，“9.9元包邮”已经成为一个消费者习以为常的词语。
潮流	本义指由潮汐引起的水流运动，引申义为流行趋势的动向，比喻社会变动或发展的趋势，在电力工程中特指电网各处电压（包括幅值与相角）、有功功率、无功功率等的分布。
零食	零食，通常是指一日三餐时间点之外的时间里所食用的食品。一般情况下，人的生活中除了一日三餐被称为正餐食物外，其余的一律被称为零食。零食跟食用的时间点有关跟种类无关，比如一般南方人把面食当做零食，但其却是北方人的主食。零食可分为三类，原产品零食、初加工零食和深加工零食。很多一般儿童比较喜欢吃零食，但吃过多深加工零食易造成偏食和肥胖现象。但对于老年人来说适当吃些零食对身体健康有益处，但是多食也是无益的，在选购零食时请注意选择健康零食，尽量少糖。一般情况下原产品零食和初加工零食是健康零食。[Snack;Between-meal nibbles] 一日三餐饭食以外的零星的食品。零食，也称零嘴、零嘴儿、小零嘴。
男装	男装，是指男性穿于身体起保护和装饰作用的服饰制品。包括上装和下装，男装会根据季节和个人的需求有不同的款式和作用。
打底	为了提高密封材料与粘结体之间的粘结性，在接缝表面必须涂打底料的过程叫做打底，对表面脆弱的粘结体，打底可除去灰尘提高面层强度，并可防止混凝土，水泥砂浆中的碱性成份渗出。
进口	进口，是指向非本国居民购买生产或消费所需的原材料、产品、服务。进口的目的是获得更低成本的生产投入，或者是谋求本国没有的产品与服务的垄断利润。
真皮	真皮是使用动物的皮制作加工而成的，概念上相对于人工使用化学纤维材料制成的人造革。市场上所说的真皮一般是头层皮、二层皮、合成皮三种之一。三种皮的价格依次递减。
连衣裙	连衣裙，是指吊带背心和裙子连在一起的服装，属于裙装的一类。连衣裙在各种款式造型中被誉为“时尚皇后”，是变化莫测、种类最多、最受青睐的款式。连衣裙是一个品种的总称，是年轻女孩喜欢的夏装首选之一。根据穿着对象的不同，可有童式连体裤和成人。连衣裙有各种样式。连衣裙还可以根据造型的需要，形成各种不同的轮廓和腰节位置。
卧室	卧室是现有家庭生活中必有需求之一。是供居住者在其内睡觉、休息或进行性活动的房间。卧室又被称作卧房、睡房，分为主卧和次卧。主卧通常指一个家庭场所中最大、装修最好的居住空间（非活动空间）。有时也指家庭中主要收入者的居住空间。次卧指区别于主卧以外的居住空间。
秋季	秋季是春夏秋冬四季之一。从气象意义上划分，北温带的秋季在8月23日（处暑）~11月20日（小雪）；南温带的秋季在2月19日（北半球雨水）~5月21日（北半球小满）。秋季最明显的变化在树木，城市开始清扫大量落叶，山区则涌进不少观赏枫红的游客。
男鞋	男鞋字面上理解为男式鞋。目前分类很多包括皮鞋，正装鞋，休闲鞋，运动鞋，跑鞋，舞蹈鞋等等，男鞋的主要特征是有别于女鞋的秀气和典雅，更显男人商务，大气，休闲的一面，目前男鞋的款式和种类有上千种之多。
上衣	【词目】上衣【拼音】shàng yī【英文】 Tops;Coat;Jacket【解释】1.外衣。2.上身穿的衣服。3.上衣的分类有学生装、军便装、夹克衫、两用衫、T恤等等类型。穿于人体上身的常用服装。一般由领、 袖、 衣身、袋4部分构成，并由此4部分的造型变化形成不同款式。4.传统服饰。外衣。此称始于汉。《论语·乡党》“当暑袗絺绤，必表而出之”，何晏集解引孔安国曰:“暑则单服。絺绤，葛也。
户外	户外，是汉语词汇，汉语拼音为hù wài，指室外露天处，与室内有区别户外活动也就是露天场所的活动。户外多数带有探险性，属于极限和亚极限运动，有很大的挑战性和刺激性。户外运动能拥抱自然，挑战自我，能够培养个人的毅力、团队之间合作精神，提高野外生存能力，深受青年人的欢迎。
男女	主要指男人和女人，男属阳，女属阴。《易·序卦》：“有天地然后有万物，有万物然后有男女，有男女然后有夫妇。”
短款	短款，读作duǎn kuǎn，汉字词语，指结账时现金的数额少于账面的数额。
防水	防水早已不再是一个新鲜的话题，不论是隧道、桥梁、堤坝、道路、建筑还是我们日常居住的房屋，防水都不容忽视。同时，我们日常生活中所使用的电器产品也存在必须直面的防水防潮问题。出处：《史记·周本纪》：“召公曰：‘是鄣之也。防民之口，甚於防水。’”《国语》作“防川”。
大码	百度百科是一部内容开放、自由的网络百科全书，旨在创造一个涵盖所有领域知识，服务所有互联网用户的中文知识性百科全书。在这里你可以参与词条编辑，分享贡献你的
学生	学生（student）一般指正在学校、学堂或其他学习地方受教育的人，而在研究机构或工作单位（如医院、研究所）学习的人也自称学生，以前与学生的性质相似的还有徒弟、弟子等等。根据学习的不同阶段，我们可以把学生分为：幼儿园学生、小学生、中学生（初中生、高中生、中专生）、高等院校学生（专科生/高职生、本科生、硕士研究生、博士研究生）等等。
百搭	百搭这个词最先是在棋牌游戏中出现的，游戏时一般要组成一种牌组，这种牌组需要特定的几种牌组成。而有些牌是可以随意充当任何牌的（比如王牌），而这类牌就叫“百搭”。
长款	百度百科是一部内容开放、自由的网络百科全书，旨在创造一个涵盖所有领域知识，服务所有互联网用户的中文知识性百科全书。在这里你可以参与词条编辑，分享贡献你的
收纳	释意[take in] 收进，留下悉数收纳收纳现金1.收留，容纳。 宋 曾巩 《太祖皇帝总叙》：“收纳学士大夫用之，不求其备。” 清 魏源 《圣武记》卷六：“廷议诸臣，恐以收纳逃亡启边衅。” 鲁迅 《坟·未有天才之前》：“做土要扩大了精神，就是收纳新潮，脱离旧套。”2.收集。 鲁迅 《序言》：“现在我将那时所做的文字的错的和至今还有可取之处的，都收纳在这一本里。”
多功能	《多功能》是一款IOS平台的应用。
北欧	北欧（Northern Europe）是政治地理名词，特指北欧理事会的五个主权国家 ：瑞典、挪威、芬兰、丹麦、冰岛。地域包括欧洲北部的挪威、瑞典、芬兰、丹麦和冰岛共五个国家，以及实行内部自治的法罗群岛。北欧西临大西洋，东连东欧，北抵北冰洋，南望中欧，总面积130多万平方千米。地形为台地和蚀余山地，冰蚀湖群、
秋冬季	百度百科是一部内容开放、自由的网络百科全书，旨在创造一个涵盖所有领域知识，服务所有互联网用户的中文知识性百科全书。在这里你可以参与词条编辑，分享贡献你的
连帽	百度百科是一部内容开放、自由的网络百科全书，旨在创造一个涵盖所有领域知识，服务所有互联网用户的中文知识性百科全书。在这里你可以参与词条编辑，分享贡献你的
女装	女士穿着的衣物统称为女装。服饰的变迁是一部历史，是一个时代发展的缩影。它是这个时代进步、文明、兴旺发达、繁荣昌盛的象征。它在记录历史变革的同时，也映衬着一种民族的文化，传承着当地的历史文化风俗，女装更是其中不可缺少的一部分。女装品牌与款式的多元化推动了时装的发展。
纯色	纯色是指一种不混有其他色调的色彩或色相。光束或光谱是纯色，但没有一种颜料或色料不含有其他色相的某些成份。在绘画中，纯色也可能意味着直接从锡管中挤出，未和其他色混合的颜色。必要是，仅用白色使色彩亮起来，用更多的同种颜色使色彩深下去，而不用其他颜色。色彩纯净度（purity color）有些不同的意思，按照色彩的类型，指色彩的明晰度。例如，茜素的基调是纯粹明净的，而印度红的基调则比较混浊。色料纯净度（purity of pigment）的意思是不带杂质。
美式	用料材料　　用量青椒1/4红椒1/4洋葱少许培根2片西红柿1/4口蘑1个鸡蛋4枚黄油适量黑胡椒适量食盐少许做法1. 培根切碎，西红柿蘑菇青红椒洋葱切碎。 2. 四枚全蛋加少许盐打散。 3. 不沾锅放黄油融化，先肉后蔬菜撒黑椒，翻炒至熟。
秋装	秋装，顾名思义就是秋季穿的服装。从气象的角度来说，秋季指炎热的季节过后，五天的平均温度在22度以下就算进入秋季。由于秋装与其它季节的服装并没有绝对的界限，不同地方的气温也都相差很大，所以严格界定春装的范围实际上很困难，主要靠人们自己的感觉。春季与秋季的温度较接近，所以有时将这两个季节的服装统称为春秋装。
现代	现代成立于1947年，为韩国汽车品牌，主要生产suv及普通家用轿车，排量为1.6~2.7L之间的车型。
卫衣	卫衣诞生于20世纪30年代的美国纽约，当时是为冷库工作者生产的工装。但由于卫衣舒适温暖的特质逐渐受到运动员的青睐，不久又风靡于橄榄球员女友和音乐明星中。卫衣一般比较宽大，是休闲类服饰中很受顾客青睐的服饰。卫衣兼顾时尚性与功能性，融合了舒适与时尚，成为年轻人街头运动的首选。
长裤	长裤 （chángkù）指由腰及踝，包覆全腿的裤子。一般有运动裤，牛仔裤，哈伦裤，阔腿裤，西裤，颜色更是多种多样。
潮牌	潮牌，多指一些原创品牌，有自己的设计，张扬设计师的独特思想品格、风格和生活态度，整体商品被人认可为潮品的品牌。
透气	透气是汉语词汇，拼音tòu qì，解释为空气通过。
套头	套头，汉语词语，意思是指包头巾。
摆件	摆件，就是摆放在公共区域、桌、柜或者橱里供人欣赏的东西，范围相当广泛。像雕塑、铁艺、铜艺、不锈钢雕塑、不锈钢、石雕、铜雕、玻璃钢、树脂、玻璃制品、陶瓷、瓷、黑陶、陶、红陶、白陶、吹瓶、脱蜡琉璃、水晶、黑水晶、木雕、花艺、花插、浮雕、装饰艺术、仿古、仿古做旧、艺术漆、手绘大理石、特殊油漆等都属于这一系列。摆件的造型有瓶、炉、壶、如意、花瓶、花卉、人物、瑞兽、山水、玉盒、鼎、笔筒、茶具、佛像等。
情侣	情侣是一个汉语词汇，拼音是qíng lǚ，指相互吸引并相爱，在相爱期间约定永不分离。情侣之间的交流方式通常有约会，互送礼物，保持亲密关系等。
毛衣	毛衣，以机器或手工编织的毛线上衣。人类在原始生活中利用树叶、兽皮来蔽体，在渔牧生活中结网捕鱼，就懂得运用编织的技法，随着文明的演进与科技的发明，人类不仅充分利用各类动、植物等天然纤维编织出生活所需的物品，更研发出多种化学纤维、矿物纤维，使人类生活更舒适便利。
显瘦	百度百科是一部内容开放、自由的网络百科全书，旨在创造一个涵盖所有领域知识，服务所有互联网用户的中文知识性百科全书。在这里你可以参与词条编辑，分享贡献你的
不锈钢	不锈钢（Stainless Steel）是不锈耐酸钢的简称，耐空气、蒸汽、水等弱腐蚀介质或具有不锈性的钢种称为不锈钢；而将耐化学腐蚀介质（酸、碱、盐等化学浸蚀）腐蚀的钢种称为耐酸钢。由于两者在化学成分上的差异而使他们的耐蚀性不同，普通不锈钢一般不耐化学介质腐蚀，而耐酸钢则一般均具有不锈性。“不锈钢”一词不仅仅是单纯指一种不锈钢，而是表示一百多种工业不锈钢，所开发的每种不锈钢都在其特定的应用领域具有良好的性能。成功的关键首先是要弄清用途，然后再确定正确的钢种。和建筑构造应用领域有关的钢种通常只有六种。它们都含有17～22%的铬，较好的钢种还含有镍。添加钼可进一步改善大气腐蚀性，特别是耐含氯化物大气的腐蚀。不锈钢指耐空气、蒸汽、水等弱腐蚀介质和酸、碱、盐等化学浸蚀性介质腐蚀的钢，又称不锈耐酸钢。实际应用中，常将耐弱腐蚀介质腐蚀的钢称为不锈钢，而将耐化学介质腐蚀的钢称为耐酸钢。由于两者在化学成分
迷你	“迷你”，舶来词，是由英文mini一词转化而成的。意为小的，短的，袖珍型的，与“大”相反，通常形容小巧可爱的物品，如“迷你裙”（短裙）等。
夹克	读音：jiā kè 一种短上衣。翻领，对襟，多用暗扣或拉链，便于工作和活动。 沙汀《柳永慧》：“她的装束也换过了，头戴布帽，身穿一件夹克式工作服，上面全是一团团油渍。”1 
短袖	短袖是夏季人们必不可少的服装之一，以其自然，舒适，潇洒又不失庄重之感的优点，而逐步替代过去男士们穿背心或汗衫外加一件短袖衬衫或香港衫的模式，成为人们乐于穿着的时尚。
休闲鞋	休闲鞋是鞋类的一种，主要特色是以一种简单，舒适的设计理念，满足人们日常生活穿着的需求。休闲鞋的概念、内涵和功能便与这种新生活理想和方式紧密相关。人们借助休闲鞋的造型、品牌及内涵去修饰装扮自己、展示自己，从中获得一种审美愉悦和象征性的精神满足。
针织衫	针织衫是利用织针把各种原料和品种的纱线构成线圈，再经串套连接成针织物的工艺产物，即利用织针编织成的衣物。其质地松软，有良好的抗皱性与透气性，并有较大的延伸性与弹性，穿着舒适。
男童	百度百科是一部内容开放、自由的网络百科全书，旨在创造一个涵盖所有领域知识，服务所有互联网用户的中文知识性百科全书。在这里你可以参与词条编辑，分享贡献你的
陶瓷	陶瓷，英语：china。中国人早在约公元前8000－2000年（新石器时代）就发明了陶器。用陶土烧制的器皿叫陶器，用瓷土烧制的器皿叫瓷器。陶瓷则是陶器、炻器和瓷器的总称。古人称陶瓷为瓯。凡是用陶土和瓷土这两种不同性质的粘土为原料，经过配料、成型、干燥、焙烧等工艺流程制成的器物都可以叫陶瓷。
便携	便携biàn xié，汉语词语，释义为方便随身携带。
裤子	裤子，外文名trousers，泛指人穿在腰部以下的服装，一般由一个裤腰、一个裤裆、两条裤腿缝纫而成，根据材质、造型和受众的不同，有多种分类。
冬装	冬装，顾名思义就是冬天穿的服装。冬装主要有：羽绒服、夹克、毛衣、棉袄和保暖内衣以及围巾等。冬装一般适合冬天穿，当然在寒冷的地方，秋天也就需要穿冬装了。
衬衫	衬衫是一种穿在内外上衣之间、也可单独穿用的上衣。中国周代已有衬衫，称中衣，后称中单。汉代称近身的衫为厕牏。宋代已用衬衫之名。现称之为中式衬衫。公元前16世纪古埃及第18王朝已有衬衫，是无领、袖的束腰衣。14世纪诺曼底人穿的衬衫有领和袖头。16世纪欧洲盛行在衬衫的领和前胸绣花，或在领口、袖口、胸前装饰花边。18世纪末，英国人穿硬高领衬衫。维多利亚女王时期，高领衬衫被淘汰，形成现代的立翻领西式衬衫。19世纪40年代，西式衬衫传入中国。衬衫最初多为男用，20世纪50年代渐被女子采用，现已成为常用服装之一。
羽绒服	羽绒服（down coat）内充羽绒填料的上衣，外形庞大圆润。羽绒服一般鸭绒量占一半以上，同时可以混杂一些细小的羽毛，将鸭绒清洗干净，经高温消毒，之后填充在衣服中就是羽绒服了。羽绒服保暖性最好。多为寒冷地区的人们穿着，也为极地考察人员所常用。
春秋	《春秋》，即《春秋经》，又称《麟经》或《麟史》，中国古代儒家典籍“六经”之一。也是周朝时期鲁国的国史，现存版本由孔子修订而成。《春秋》是中国第一部编年体史书，共三十五卷，是儒家经典之一且为十三经中篇幅最长的，在四库全书中列为经部。记述范围从公元前722（鲁隐公元年）至公元前479年（鲁哀公十六年）。《春秋》用于记事的语言极为简练，然而几乎每个句子都暗含褒贬之意，被后人称为“春秋笔法”、“微言大义”。后来出现了很多对《春秋》所记载的历史进行补充、解释、阐发的书，被称为“传”。代表作品是称为“春秋三传”的《左传》、《公羊传》、《谷梁传》。2019年2月报道，从海昏侯墓出土简牍5200余枚，专家释读后发现包括《春秋》在内的儒家经典及其训传。
手工	手工指非机器设备批量生产而是由人工制作生产。在工业化刚刚兴起时，手工一词一度成为生产率低下、质量参差不齐的代名词。然而，在当代工业生产高度发达的年代，人们逐渐厌倦了由工厂流水线生产出的毫无差别和特色的产品，手工制品又恢复了活力。
印花	印花，由政府出售，贴在契约﹑凭证等上面，作为税款的一种特制印刷品。旧时一种用于缄封公文的凭证，如：印花税票。
圆领	圆领 指领角呈半圆形的领型，也叫圆角领。起源于中东的亚述帝国时代的闪米特人。
保湿	保湿是指皮肤的保湿。当空气温度降低时，皮肤角质层不能及时调节足够的保湿因子，油脂腺活跃度下降，脸上油脂、水分下降，皮肤会出现紧绷现象、甚至在眼下及鼻旁出现细纹，通过使用具有相应效果的护肤、养肤品，滋润皮肤并防止肌肤蒸发、改善微循环，增强肌肤湿润度的过程，就叫保湿，最好的保湿就是肌肤与补水产品的良性互动。
运动	运动，一种涉及体力和技巧且由一套规则或习惯所约束的行为活动，通常具有竞争性。没有不运动的物件，也没有能离开物件的运动。运动具守恒性，即运动既不能被创造又不能被消灭，其具体形式则是多样的并且能互相转化，在转化中运动总量不变。在几何中，刚性运动被描述为：平面到其自身的一个映射且使任意两点A,B的距离与其象A‘=M(A),B'=M(B)的距离相同。哲学上，运动的定义是：物在时空中的线性迁移。词性：并列结构，只是指同一个概念。
日式	百度百科是一部内容开放、自由的网络百科全书，旨在创造一个涵盖所有领域知识，服务所有互联网用户的中文知识性百科全书。在这里你可以参与词条编辑，分享贡献你的
休闲裤	休闲裤，与正装裤相对而言，就是穿起来显得比较休闲随意的裤子。广义的休闲裤，包含了一切非正式商务、政务、公务场合穿着的裤子。现实生活中主要是指以西裤为模板，在面料、版型方面比西裤随意和舒适，颜色则更加丰富多彩的裤子。休闲裤，面料舒适，款式简约百搭。虽说男士的裤型不像女士裤型那样多变，但是仍然有着自己的变化。
小脚	小脚，又名“三寸金莲”，特指缠足女子的脚，因其“小”而得名。缠足开始于宋朝，兴起于南宋，后传于民间，且越演越烈。
牛仔裤	牛仔裤又称“坚固呢裤”。一种男女穿用的紧身便裤。前身裤片无裥，后身裤片无省，门里襟装拉链，前身裤片左右各设有一只斜袋，后片有尖形贴腰的两个贴袋，袋口接缝处钉有金属铆钉并压有明线装饰。具有耐磨、耐脏，穿着贴身、舒适等特点。牛仔裤一般采用牛仔布(Denim)等靛蓝色水洗面料， 最早出现在美国西部，曾受到当地的矿工和牛仔们的欢迎，在当代仍然十分流行。牛仔裤因为耐磨，有的面料柔软，穿在身上时尚而舒适，受到年轻人的喜爱。
个性	个性亦称“人格”。指个人的精神面貌或心理面貌。个性（人格）一词来自拉丁文“persona”，原指演员所戴的“面具”，后来引申为人物、角色及其内心的特征或心理面貌。在心理学中，个性与人格都有广义和狭义之分。广义的个性与人格是同义词，二者均指个人的一些意识倾向和各种稳定而独特的心理特征的总和。狭义的个性通常指个人心理面貌中与共性相对的个别性，即个人独具的心理特征。狭义的人格通常指个人的一些与意识倾向相联系的心理特征的综合表现，有时，甚至仅指个人的品德、操行。在欧洲，有些心理学家把人格看作是性格的同义词。
沙发	“沙发”是个外来词，根据英语单词sofa 音译而来。为一种装有软垫的多座位椅子。装有弹簧或厚泡沫塑料等的靠背椅，两边有扶手，是软装家具的一种。沙发的起源可追溯到公元前2000年左右的古埃及，但真正意义的软包沙发则出现于十六世纪末至十七世纪初。
夏季	夏季是一年的第二个季节，是四季之一。在大多数地区夏季是气候炎热、有可能缺水的季节，此外，由于夏季时北半球大部份学生都放暑假，因此也是相当旺盛的旅游季节。在北温带，气象意义上的夏季为5月21日（小满）~8月22日（处暑）；在南温带，气象意义上的夏季为11月21日（北半球的小雪）~次年2月18日（北半球的雨水）。
女士	女士是在不确定对方婚姻状况时使用之女性称谓。近代对女性称谓通常视对方已婚与否而定，未婚者称“小姐”（英文：Miss），已婚者称“太太”（英式英文：Mrs/美式英文及旧英式英文 Mrs.）。但有时未必知道对方婚姻状况，或已婚者不欲从夫姓，又或根本不欲别人知道其婚姻状况，即可使用。例如年轻者称“小姐”，较年长者称“女士”；又或不论年纪一律称“女士”。在英语社会，“女士”（英式英文：Ms/美式英文及旧英式英文：Ms.）此称谓由来已久，但广泛使用始于二十世纪后期美国，由于女权高涨，要求男女平等，认为既然男性有不反映婚姻状况之“先生”（英式英文：Mr/美式英文及旧英式英文：Mr.）称谓，亦应有对应不反映婚姻状况之女性称谓，因而产生“女士”此一头衔，并逐渐传至东亚。“女士”亦可用作 Madam 或 Lady 之翻译。而在跨性别课题上，以女士身份社交的人员，仅从其心理性别角度上而不论其生殖性别为女性或男
英伦	英伦三岛是大不列颠及北爱尔兰联合王国的俗称，包括英格兰、苏格兰、威尔士以及北爱尔兰等。“英伦三岛”一词是国人对“英国”或“大不列颠”的别称，一般出现在非正式场合或文学艺术作品中。
组合	组合（combination）是一个数学名词。一般地，从n个不同的元素中，任取m（m≤n）个元素为一组，叫作从n个不同元素中取出m个元素的一个组合。我们把有关求组合的个数的问题叫作组合问题。
可爱	可爱，意思是令人敬爱的，也指令人喜爱的,讨人喜欢的,深受热爱的。字面意义为令人喜爱，原本含义为在幼小或初生的、柔弱的生物或类幼儿事物身上体现出的令三观正常的人产生正面的愉悦进而喜爱的情绪特征。现在它可以在精神层面用来形容天真无邪，心灵单纯、美。有些阳光型大男孩或者妙龄少女也可用可爱形容，较少用来形容拥有童心的成年人或老年人。可爱在某一方面与呆综合在一起用在老实人身上可指“憨”，也可指“萌”。
卡通	卡通：英语卡通：蔷薇属栽培品种
童装	儿童服装简称童装，指适合儿童穿着的服装。按照年龄段分包括婴儿服装、幼儿服装、小童服装、中童服装、大童服装等。还包括中小学的校园服装等。按照衣服的类型分为：连体服，外套，裤子，卫衣，套装，T恤衫，鞋等。童装衣服的料子要求比成人高，既要好看，穿着又要舒服，关键还是童装质量要有保证，不能损害儿童健康。
单肩	百度百科是一部内容开放、自由的网络百科全书，旨在创造一个涵盖所有领域知识，服务所有互联网用户的中文知识性百科全书。在这里你可以参与词条编辑，分享贡献你的
中式	中式是一个汉语词汇，读音为zhōng shì，多重意思。现代常指中国固有的格式，如：中式餐点、中式餐具等。在古代指科举考试被录取或符合规格的意思。
防滑	百度百科是一部内容开放、自由的网络百科全书，旨在创造一个涵盖所有领域知识，服务所有互联网用户的中文知识性百科全书。在这里你可以参与词条编辑，分享贡献你的
玩具	玩具，泛指可用来玩的物品，玩玩具在人类社会中常常被作为一种寓教于乐的方式。玩具也可以是自然物体，即是沙、石、泥、树枝等等的非人工东西，对玩具应作广义理解，它不是只限于街上卖的供人玩的东西，凡是可以玩的、看的、听的和触摸的东西，都可以叫玩具。玩具适合儿童，更适合青年和中老年人。它是打开智慧天窗的工具，让人们机智聪明。
跑步	跑步的定义是指陆生动物使用足部移动。它在运动上的定义是一种步伐，双脚不会同一时间踫到地面。它亦可以是一种有氧的运动或厌氧的运动。
商务	商务概念的提出是改革的产物，有一个演变的过程：贸易部——商业部、外贸部——内贸部——内贸局——商务部。是内外贸一体化的概念。
韩国	大韩民国（韩语：대한민국，英语：Republic of Korea），简称“韩国”（South Korea）。位于东亚朝鲜半岛南部，总面积约10万平方公里（占朝鲜半岛面积的45%），主体民族为韩民族，通用韩语，总人口约5164万。首都为首尔。韩国三面环海，西濒临黄海，东南是朝鲜海峡，东边是日本海，北面隔着三八线非军事区与朝鲜相邻。1910年朝鲜半岛沦为日本殖民地，1945年8月15日光复取得独立。1948年8月和9月，依北纬38度线，朝鲜半岛南北先后成立大韩民国和朝鲜民主主义人民共和国。1950年爆发朝鲜战争，1953年7月27日依朝鲜停战协定，朝韩双方停战。20世纪60年代以来，韩国政府实行了“出口主导型”开发经济战略，创造了被称为“汉江奇迹”的经济高速增长期，并跻身“亚洲四小龙”之一。
针织	利用织针把各种原料和品种的纱线构成线圈、再经串套连接成针织物的工艺过程。针织物质地松软，有良好的抗皱性与透气性，并有较大的延伸性与弹性，穿着舒适。针织产品除供服用和装饰用外，还可用于工农业以及医疗卫生和国防等领域。针织分手工针织和机器针织两类。手工针织使用棒针，历史悠久，技艺精巧，花形灵活多变，在民间得到广泛流传和发展。
运动鞋	运动鞋是根据人们参加运动或旅游的特点设计制造的鞋子。运动鞋的鞋底和普通的皮鞋、胶鞋不同，一般都是柔软而富有弹性的，能起一定的缓冲作用。运动时能增强弹性，有的还能防止脚踝受伤。所以，在进行体育运动时，大都要穿运动鞋，尤其是高烈度体能运动，如：篮球、跑步等。
特产	特产指某地特有的或特别著名的产品，有文化内涵或历史，亦指只有在某地才生产的一种产品。在英文中，特产译作speciality product或Specialty，后者特指“特制独特品种或具有特殊优势的项目或产品”（An item or a product of a distinctive kind or of particular superiority），强调品质上具有“特别的或独特的状况或品质”（The quality of being special or distinctive）。有时为了强调特产的地域特性，使用special local product来表示地方特产，相当于汉语中的“土特产”的概念。例如云南特产的取名就是根据特产加上民族文化来取的。
棉服	棉服是以棉花、羽绒等物料为填充制作而成，用于防寒的服饰。长棉服经常被认为是臃肿的代表，害怕变胖的MM都不穿棉服了，土气又不漂亮。其实，棉服搭配得体，一样会显得高挑的。
薄款	百度百科是一部内容开放、自由的网络百科全书，旨在创造一个涵盖所有领域知识，服务所有互联网用户的中文知识性百科全书。在这里你可以参与词条编辑，分享贡献你的
新品	《新品》是作者 逆天良少发表在 幻剑书盟连载网站的一本小说。
黑色	黑色基本上定义为没有任何可见光进入视觉范围，与白色正相反，白色是所有可见光光谱内的光都同时进入视觉范围内。颜料如果吸收光谱内的所有可见光，不反射任何颜色的光，人眼的感觉就是黑色的。如果将三原色的颜料以恰当的比例混合，使其反射的色光降到最低，人眼也会感觉为黑色。所以黑色既可以是缺少光造成的（漆黑的夜晚），也可以是所有的色光被吸收造成的（黑色的瞳孔）。从宇宙观的角度讲，黑是宇宙的本质，即为宇宙的真实面目。
厨房	厨房，是指可在内准备食物并进行烹饪的房间，一个现代化的厨房通常有的设备包括炉具（瓦斯炉、电炉、微波炉或烤箱）、流理台（洗碗槽或是洗碗机）及储存食物的设备（例如：冰箱、冰柜）。纵观中国历史上厨房格局的演变，它一方面取决于生产力的发展，另一方面也决定于当地的自然条件和居民的生活习惯。通过不同时期的演变，厨房的功能性逐渐走向合理。
ins	INS是Incident Notification System的缩写，意思是智能安全模块，可实现HELP键紧急求助、碰撞求助、防盗报警、位置查询的功能，通过车内置的一张SIM卡对应一个手机号来实现。
蕾丝	女同性恋，又称女同、拉拉、百合、蕾丝边、Lesbian、Les、 Girlslove。是指只对同性产生爱情和性欲的女性。尽管自古以来女同性恋曾被记载于多处文化中，但是直至今日才出现蕾、蕾丝边、拉拉等字词，用以形容女同性恋者。十九世纪晚期，性学家发表了他们对同性欲望与行为表现的研究，标明了女同性恋者在西方文化中是属于独立的群体。因此，意识到自身新医学身份的女性逐渐在欧洲与北美洲形成秘密次文化。黑色三角形代表着女同性恋的身份标识，它来源于纳粹德国，当时使用它在集中营中区分被认为是“反社会”的女性（例如：对纳粹家庭价值观构成威胁的人）。如果有女人反对生育或反对传统家庭价值观，则会被冠上黑色倒三角形。现在黑色三角形是作为女同性恋自豪的标志。
牛皮	牛皮是动物牛的表皮，因皮质细腻，牢固耐用，常被用于工艺品。牛皮也是一个汉语词汇，可比喻物品柔软而有韧性，也可指虚套的话。
置物架	置物架是采用底板及支柱组合而成放置杂物的架子。多由条形支架支撑，加以底板作承托，造型独特，设计灵巧，装卸简便，洁净亮丽，开放式的设计，令储物一眼可见。由于置物架在家庭生活中的应用越来越广泛，很多家庭生活用品种类也越来越多，所以需要一个可以进行整顿和归置这些生活用品的一个置物架，而置物架的设计非常的简洁和大方同时又具备灵巧，所以对于归置生活物品很有作用，关键是有利于生活物品能够很好的取拿不用很费力的寻找。
刺绣	刺绣是针线在织物上绣制的各种装饰图案的总称。刺绣分丝线刺绣和羽毛刺绣两种。就是用针将丝线或其他纤维、纱线以一定图案和色彩在绣料上穿刺，以绣迹构成花纹的装饰织物。它是用针和线把人的设计和制作添加在任何存在的织物上的一种艺术。刺绣是中国民间传统手工艺之一，在中国至少有二三千年历史。中国刺绣主要有苏绣、湘绣、蜀绣和粤绣四大门类。刺绣的技法有：错针绣、乱针绣、网绣、满地绣、锁丝、纳丝、纳锦、平金、影金、盘金、铺绒、刮绒、戳纱、洒线、挑花等等，刺绣的用途主要包括生活和艺术装饰，如服装、床上用品、台布、舞台、艺术品装饰。
大容量	百度百科是一部内容开放、自由的网络百科全书，旨在创造一个涵盖所有领域知识，服务所有互联网用户的中文知识性百科全书。在这里你可以参与词条编辑，分享贡献你的
补水	补水：美容概念补水：河道生态补水
日本	日本国（日语：にっぽんこく、にほんこく；英语：Japan），简称“日本”，位于东亚、国名意为“日出之国”，领土由北海道、本州、四国、九州四个大岛及6800多个小岛组成，总面积37.8万平方公里。主体民族为大和族，通用日语，总人口约1.26亿。日本三大都市圈是东京都市圈、大阪都市圈和名古屋都市圈。日本是一个太平洋西岸的岛国。西隔东海、黄海、朝鲜海峡、日本海与中国、朝鲜、韩国等国相望。属温带海洋性季风气候，终年温和湿润。6月多梅雨，夏秋季多台风。3世纪中叶，其境内出现大和国。645年，日本向中国唐朝学习，进行大化改新。12世纪后期，天皇皇
毛呢	它是对用各类羊毛、羊绒织成的织物的泛称。它通常适用以制作礼服、西装、大衣等正规、高档的服装。它的优点是防皱耐磨，手感柔软，高雅挺括，富有弹性，保暖性强。它的缺点主要是洗涤较为困难，不大适用于制作夏装。
定制	“定制”一词起源于萨维尔街，意思是为个别客户量身剪裁。萨维尔街(Savile Row)是一个在伦敦中央梅费尔(Mayfair)的购物街区，因为传统的定制男士服装行业(bespoke tailoring)而闻名。随着时代发展，“定制”一词的意义也逐渐被丰富起来，比如定制服装、礼品，甚至出现了定制肤色、定制蔬菜等，迎合了人们追求品质和个性的心理，定制才是真正的个性化消费。美国预测的“改变未来的十大技术”中，“个性定制”被排在首位，其市场地位越来越被人们认可。
高腰	高腰是明显高于自然腰节线的腰线位置。现代一般指高出正常腰节线3公分或以上的腰线位置。高腰有高腰括与高腰裤，似裙似裤的裙裤也可以是高腰。高腰时装在腰部基本都紧身合体，绝大部分是女装，用以表现女性婀娜的腰肢，衬托出臀部圆润饱满的曲线，使下肢显得修长而增添亭亭玉立之感。
全棉	全棉指含棉量为100%的衣物或者用品，一般为平布、府绸、斜纹布、劳动布等，与一般布料不同的是它具有防臭、透气、舒适等优点，尽量不要用洗衣粉，最好用透明皂。
女鞋	女鞋，是现今女性日常服饰搭配中不可缺少的一项。每个女人都希望拥有一双属于自己的鞋子。美丽不合脚的鞋子会让你疼痛，流血。只适合自己脚的鞋子才不会让脚流血。舒适才是最重要的。
鞋子	鞋子，穿在脚上防止脚受到伤害的一种物品，在人类文明史前期多为草鞋、布鞋，如今以皮鞋、运动鞋、休闲鞋、高跟鞋较为多见。
茶具	现代人所说的“茶具”主要指茶壶、茶杯、茶勺等这类饮茶器具。唐代文学家皮日休《茶具十咏》中所列出的茶具种类有“茶坞、茶人、茶笋、茶籝、茶舍、茶灶、茶焙、茶鼎、茶瓯、煮茶。”其中“茶坞”是指种茶的凹地。“茶人”，按照现代观点，不应纳入器具。
手机	手机、全称为移动电话或无线电话，通常称为手机，原本只是一种通讯工具，早期又有大哥大的俗称，是可以在较广范围内使用的便携式电话终端，最早是由美国贝尔实验室在1940年制造的战地移动电话机发展而来。1958年，苏联工程师列昂尼德.库普里扬诺维奇发明了ЛК-1型移动电话，1973年，美国摩托罗拉工程师马丁·库帕发明了
羊毛	羊毛主要由蛋白质组成。人类利用羊毛可追溯到新石器时代，由中亚向地中海和世界其他地区传播，遂成为亚欧的主要纺织原料。羊毛纤维柔软而富有弹性，可用于制作呢绒、绒线、毛毯、毡呢等纺织品。羊毛制品有手感丰满、保暖性好、穿着舒适等特点。绵羊毛在纺织原料中占相当大的比重。世界绵羊毛产量较大的有澳大利亚、前苏联、新西兰、阿根廷、中国等。绵羊毛按细度和长度分为细羊毛、半细毛、长羊毛、杂交种毛、粗羊毛等5类。中国绵羊毛品种有蒙羊毛、藏羊毛、哈萨克羊毛。评定羊毛品质的主要因素是细度、卷曲、色泽、强度以及草杂含量等。
装饰	装饰是一个汉语词汇，拼音是zhuāng shì，意思指1.打扮；修饰，2.装潢，3.点缀，装点，4.指装饰品，5.犹夸饰。出自《后汉书·逸民传·梁鸿》：“﹝孟光﹞及嫁，始以装饰入门。七日而鸿不答。”
开衫	开襟衫，上衣的一种式样。前面的部分全部分开，纽扣在胸前的叫对开襟，可分为有扣和无扣，面料一般为针织。开衫，将开襟衫敞开衣襟的一种穿衣方式，但往往习惯将开襟衫称为开衫。开衫是各个季节的百搭单品，款式虽然简单，但是丰富的颜色，和简洁的设计正是以不变应万变，无论是搭配衬衣，还是搭配T恤或是连衣裙，都能穿出女性清新柔美的气质。无论是长袖款还是马甲（无袖），都很适合男士或女士搭配出自如的风格。
水杯	水杯汉语拼音是 shuǐ bēi，又称杯子，英语名是 cup 。水杯通常是人们盛装液体的容器，平时可用来喝茶、喝水、喝咖啡、喝饮料等。水杯是一种大多数情况下用来盛载液体的器皿。通常用塑胶、玻璃、瓷或不锈钢制造，在餐厅打包饮料，则常用纸杯或胶杯盛载。杯子多呈圆柱形，上面开口，中空，以供盛物。因杯开口，杯内液体易被四周尘埃污染，所以当长时间放置，多用杯盖遮掩。盛载热饮的杯有手柄，这样方便使用。在各国的不同领域和文化中，杯子的形状有个不一样，可以说文化决定形状。水杯也有很多种类，如保温杯，开口杯，环行杯，智能水杯等等。
手表	手表，或称为腕表，是指戴在手腕上，用以计时/显示时间的仪器，手表在英语里watch源自中世纪wacche这一词汇。手表通常是利用皮革、橡胶、尼龙布、不锈钢等材料，制成表带，将显示时间的“表头”束在手腕上。
同款	百度百科是一部内容开放、自由的网络百科全书，旨在创造一个涵盖所有领域知识，服务所有互联网用户的中文知识性百科全书。在这里你可以参与词条编辑，分享贡献你的
青年	青年是一个汉语词语，拼音是qīng nián]，青年的含义在全世界不同的社会中是不同的，而青年的定义随着政治经济和社会文化环境的变更一直在变化。根据世界卫生组织确定新的年龄分段，青年人的年龄上限已经提高到44岁。从1995至2000年，世界青年人口的估计数从10.26亿增长至10.66亿，在全球人口中所占的比例从18.1%降至17.6%。随着世界人口的老龄化，青年占全球总人口比例预计到2050年将继续下降至13.2%，届时15至44岁的青年人总数将是11.76 亿人。
茶几	茶几一般分方形、矩形两种，高度与扶手椅的扶手相当。通常情况下是两把椅子中间夹一茶几，用以放杯盘茶具，故名茶几。网络用语，悲剧因与“杯具”同音，惨剧因与“餐具”谐音，从而引申出“承载悲剧（杯具）和惨剧（餐具）的环境”为 茶几。茶几在中国是入清之后开始盛行的家具。从明代绘画中所见，当时香几兼有茶几的功能，到了清代，茶几才从香几中分离出来，演变为一个独立的新品种。一般来讲，茶几较矮小，有的还做成两层式，与香几比较容易区别。
小户型	小户型（SOLO）原本的意思是指独奏、单独、单飞。在这里，它指的是超小的户型，主要的定义要素是：每套建筑面积在60平方米左右，卧室和客厅没有明显的划分，整体浴室，开敞式环保节能型整体厨房；公共空间也SOLO化，即24小时便利店、24小时自助型洗衣店、24小时自助式健身房等。SOLO的消费群体是年轻人，他们或是外地人，或是本地想独立的年轻人。SOLO的户形设计以超小为特点，一般为30多平方米至60平方米左右。
原创	原创是独立完成的创作。原创不属于歪曲、篡改他人创作或者抄袭、剽窃他人创作而产生的作品，亦不属于改编、翻译、注释、整理他人已有创作而产生的作品。特指自己写的、非抄袭或转载的博文。这个含义本不恰当，因网络上已普遍流行，根据“约定俗成”的规则，应予认可。但在这个意义上应该慎用或少用，避免造成误解。
棉衣	棉衣是为了御寒，中间絮上了棉花等保温材料的衣服。棉衣中有大量的棉花或者鸭绒，所以能吸收很多空气，而空气是热的不良导体，不容其产生热交换，人身上的热量就不容易逃跑了，人就会感到温暖。
风衣	风衣 ，一种防风的轻薄型大衣。风衣是服饰中的一种，适合于春、秋、冬季外出穿着，近二三十年来比较流行的服装。由于造型灵活多变、健美潇洒、美观实用、款式新颖、携带方便、富有魅力等特点，深受中青年男女的喜爱，现在老年人也爱穿着。
日系	百度百科是一部内容开放、自由的网络百科全书，旨在创造一个涵盖所有领域知识，服务所有互联网用户的中文知识性百科全书。在这里你可以参与词条编辑，分享贡献你的
直筒	百度百科是一部内容开放、自由的网络百科全书，旨在创造一个涵盖所有领域知识，服务所有互联网用户的中文知识性百科全书。在这里你可以参与词条编辑，分享贡献你的
弹力	亦称“弹性力”。物体受外力作用发生形变后，若撤去外力，物体能恢复原来形状的力，叫作“弹力”。它的方向跟使物体产生形变的外力的方向相反。因物体的形变有多种多样，所以产生的弹力也有各种不同的形式。例如，一重物放在塑料板上，被压弯的塑料要恢复原状，产生向上的弹力，这就是它对重物的支持力。将一物体挂在弹簧上，物体把弹簧拉长，被拉长的弹簧要恢复原状，产生向上的弹力，这就是它对物体的拉力。不仅塑料、弹簧等能够发生形变，任何物体都能够发生形变，不发生形变的物体是不存在的。不过有的形变比较明显，能直接见到；有的形变相当微小，必须用仪器才能觉察出来。
2017	2017为应用最早的一种硬铝,一般称为标准硬铝,具有中等强度,在退火、刚淬火和热状态下可塑性尚好,可热处理强化,在淬火和自然时效状态下使用,点焊焊接性良好，进行气焊及氩弧焊时有裂纹倾向；包铝板材有良好的腐蚀稳定性。可切削在淬火时效状态下尚好，在退火状态时不良。
衬衣	衬衣（shirt，underclothes）是指贴身穿在里面的单衣，也称衬衫。最早源于1600 年代后期的欧洲，1900年后，衬衣在世界各地流行。有人把香水比作女人的第二件衣裳，对追求实在感的男人来说，衬衫就是男人的第一层肌肤。最早的衬衣在扣子还没被运用前，男人衬衫的衣襟是用绳子系住的。
原装	所谓原装，是指由原厂生产，而非委外或其他授权的厂家联合组装而成的产品。 我国目前存在较多的生产条件不完善，生产技术不过硬的厂家，不断受委于某些知名品牌生产产品的零部件，或贴牌，或合资生产，但由于自身的原因，导致最终产品总体性参差不齐，所以消费者心里总有对“原装”的渴望。总希望能选择到，性能/品质等各方面都比较好的“原装”产品。 如手机，“原装”机是指原厂生产，没有经由其他厂家贴牌/增减功能的，且之后没有因任何原因拆机、修理过的产品。 举例： 1）Cubita原装进口咖啡：就是完全在古巴生产加工完成的Cubita咖啡，进口到中国后没有加工改造的。 2)中国原装生产的汽车：就是完全在中国生产的汽车，出口到国外后没有经过加工改造的。 
皮鞋	皮鞋（leather shoe）是指以天然皮革为鞋面，以皮革或橡胶、塑料、PU发泡、PVC等为鞋底，经缝绱、胶粘或注塑等工艺加工成型的鞋类。皮鞋透气、吸湿，具有良好的卫生性能，是各类鞋靴中品位最高的鞋。几千年前，人类的祖先就有了穿鞋的习惯，用兽皮裹足、从皮造履到现代皮鞋，皮鞋的历史相当悠久。在中国，现代皮鞋的生产还只有120多年的历史，但由于皮鞋的造型、款式、结构以及穿着功能都胜其它鞋类，因此，皮鞋生产发展迅猛。当今，皮鞋已成为人们最喜爱的一种鞋类，成为美化人民生活的大宗商品之一，在服饰类中成为“举足轻重”的产品。
车载	所谓车载，当然是指专门在汽车上使用的产品，方便在汽车运动中使用，大家最常见的是车载MP3,MP4,GPS,车载DVD，车载硬盘机，车载电源，车载冰箱，车载按摩器，车载电脑，车载电视、车载硬盘机、车载空气净化器、车载U盘录像机等。
专用	专用，拼音为zhuān yòng，汉语词语，是指专门用于，专项使用的意思。
立领	立领是正装衣服风格，是指领子穿着的时候是立起来的，而且没有办法翻下去。立领服装讲究的就是简洁、利落、挺拔。推荐搭配为深色立领西服套装（立领白衬衫+深色立领西装）。
懒人	懒人一般是指不爱劳动的人。据英国权威医学杂志《柳叶刀》发表报告称：在调查了全球122个国家后发现，全球三分之一的成年人是运动量不足的懒人，坐沙发、看电视等懒人生活方式每年致死约500万人，甚至每天久坐三小时就会减寿两年。
高领	高领，男，汉族，1961年3月出生，河北蔚县人，大学学士，1988年10月入党，1984年7月参加工作。现任张家口市环境保护局局长。
led	发光二极管简称为LED。由含镓（Ga）、砷（As）、磷（P）、氮（N）等的化合物制成。当电子与空穴复合时能辐射出可见光，因而可以用来制成发光二极管。在电路及仪器中作为指示灯，或者组成文字或数字显示。砷化镓二极管发红光，磷化镓二极管发绿光，碳化硅二极管发黄光，氮化镓二极管发蓝光。因化学性质又分有机发光二极管OLED和无机发光二极管LED。
汽车	我国国家最新标准《汽车和挂车类型的术语和定义》(GB/T 3730．1—2001)中对汽车有如下定义：由动力驱动，具有4个或4个以上车轮的非轨道承载的车辆，主要用于：载运人员和（或）货物；牵引载运人员和(或)货物的车辆；特殊用途。
公主	公主，是中国古代对皇女、王女、宗女的称号，简称为主，与公主对应的男性称号为王。起源，《公羊传》曰‘天子嫁女子于诸侯，必使诸侯同姓者主之’，故谓之公主。”西周春秋爵称，可大致分为王、公、侯、伯、子、男六级。而在王即周天子以下就是公侯伯子男五等，周天子把女儿嫁给诸侯时，不亲自主持婚礼，让同为姬姓公爵级别的诸侯主婚，这便是“公主”的由来。并且因为周王室姓姬，所以周天子的女儿也称“王姬”，《诗经·召南·何彼襛矣》就写到：“何彼襛矣，美王姬也。”此后“王姬”也成为帝王的女儿的代称。诸侯之女也称为公主，《史记·吴起列传》记载“公叔为相，尚
九分	百度百科是一部内容开放、自由的网络百科全书，旨在创造一个涵盖所有领域知识，服务所有互联网用户的中文知识性百科全书。在这里你可以参与词条编辑，分享贡献你的
新生儿	新生儿，就是指的是胎儿娩出母体并自脐带结扎起，至出生后满28天这一段时间的婴儿。宝宝出生后， 应尽早进行哺乳，这样可以促进母亲乳汁分泌。新生儿健康应具有十个方面的标准，自主呼吸必备条件，需要注意初次呼吸注意的事项以及体检、常见病等。2019年5月15日，美国疾病控制和预防中心发布数据称，2018年美国有约378.8万名婴儿诞生，同比下降2%，连续4年下跌。
背包	背包(BackPack)指外出或行军时背在背上的包的统称。材质多样化，真皮、塑料材质、涤纶、帆布、尼龙，棉麻等质地箱包引领时尚潮流。同时，在越来越标榜个性的时期，简约、复古、卡通等各类风格也从不同侧面迎合时尚人士张扬个性的需求。箱包的款式也由传统的商务包、书包、旅行包向笔袋、零钱包、小香包等扩展。
牛仔	牛仔布的生产起源于美国，。李维·施特劳斯原是德国犹太人。第一件牛仔服诞生于19世纪中叶，19世纪90年代才在美国投入大批量生产。当时，美国人为牛仔服在美国诞生而感到莫大的自豪和骄傲，1975年美国庆祝建国200周年时，在华盛顿国家博物馆还曾经展出了一条所谓的“李维”式牛仔裤，吸引了在场人的诸多眼球。牛仔服直到20世纪六七十年代才开始在我国流行，而牛仔布始终伴随着牛仔服装的发展而发展，倘若追溯牛仔布的发展历史，也应该有上百年了，牛仔布经历了百年风雨的洗礼后，长盛不衰，且市场越来越大，因为牛仔面料与服装老少皆宜穿著，有很强的通用性，它将长期成为国内外服装消费者所青睐的时装之一。可以说，当牛仔服装在中国兴起之时，中国的千千万万消费者就“春夏秋冬”都割舍不下对她的眷恋之情。
衣服	衣服，汉语名词，读作（yī fu），是指人类或通过人类来完成遮掩身体、载体的用布料（如棉布、丝绸、天鹅绒、化学纤维 涤纶 麻等）等材质做成的各种样式的遮挡物。衣服在不同的场合有不同的穿着，样式非常的多，衣服在当今已经成为了不可或缺的东西，中国常说的“衣食住行”中排在首位。
礼盒	礼盒是以亲友礼物表达情意为主要目的的配备的实用礼品包装，是包装方式的一种功能的社会需要的延伸 。
家居	家居（拼音jiā jū）指的是家庭装修、家具配置、电器摆放等一系列和居室有关的甚至包括地理位置（家居风水）都属于家居范畴。
1.8	百度百科是一部内容开放、自由的网络百科全书，旨在创造一个涵盖所有领域知识，服务所有互联网用户的中文知识性百科全书。在这里你可以参与词条编辑，分享贡献你的
拼接	拼接，动词，汉语拼音为 pīnjiē ，英文为 put together，joint 意思是接在一起。在以前技术不发达的情况下，各种图像不能有效地拼接，随着科技的发展，液晶屏及其他各种显示设别已经很好的解决了这个问题。
孕妇	孕妇是‎怀孕的妇女，是人类社会的一个身份，她们有共同的心理、生理特征，以及消费需要。孕妇怀孕期是需要加强营养的特殊生理时期，因为胎儿生长发育所需的所有营养素均来自母体，孕妇本身需要为分娩和分泌乳汁储备营养素，所以，保证孕妇孕期营养状况维持正常对于妊娠过程及胎儿、婴儿的发育， 均有很重要的作用。
玄关	玄关是一个汉语词语，拼音是xuán guān，又称门厅，是指建筑物入门处到正厅之间的一段转折空间，东亚传统建筑中具有“藏”的概念，玄关是屋外和屋内的缓冲，使屋外与屋内有一定的隔开。
500g	百度百科是一部内容开放、自由的网络百科全书，旨在创造一个涵盖所有领域知识，服务所有互联网用户的中文知识性百科全书。在这里你可以参与词条编辑，分享贡献你的
短靴	短靴是帮子略呈筒状高到踝子骨以上的鞋。靴，原为北方游牧民族所穿，又称马靴和高筒靴。相传靴的发明者为战国时代著名军事家孙膑，为纪念孙膑，旧时鞋匠们便奉他为制鞋业的始祖，设牌位，挂画像供奉。现存最早的靴，是新疆孔雀河古墓出土靿至胫的牛皮靴，可见3800余年前的新疆已出现了靴子。
四件套	“四件套”在人们的日常生活中通常指床上用品四件套，顾名思义就是四个套件组成的床上用品，必要元素为一对枕套，一条被套，加一条床单（床单款）或者一张床笠（床笠款）或者一个床裙（床裙款）。
无线	无线英文：wireless。一般来说，“无线”指的是无线电或无线电波，通信领域范畴。例如：无线网络 (如“无线网桥、无线AP”）、电视广播有限公司 (又称“无线电视台”)
通用	通用电气公司，即美国通用电气公司（General Electric Company，简称GE，创立于1892年，又称奇异公司，NYSE：GE），是世界上最大的提供技术和服务业务的跨国公司。自从托马斯·爱迪生创建了通用电气公司以来，GE在公司多元化发展当中逐步成长为出色的跨国公司。目前，公司业务遍及世界上100多个国家，拥有员工315,000人。2016年10月，通用电气公司排2016年全球100大最有价值品牌第十名。 美国通用电气公司2017年6月1日宣布，在天津空港经济区启用其首个美国以外、服务于多个业务部门的智能制造技术中心。 在2018年7月19日发布的2018年《财富》世界500强排行榜中，排名第四十一。2017年6月，《2017年BrandZ最具价值全球品牌100强》公布，通用电气公司排名第19位。2018年12月18日，世界品牌实验室编制的《2018世界品牌500强》揭晓，通用
网红	“网络红人”是指在现实或者网络生活中因为某个事件或者某个行为而被网民关注从而走红的人或长期持续输出专业知识而从红的人。他们的走红皆因为自身的某种特质在网络作用下被放大，与网民的审美、审丑、娱乐、刺激、偷窥、臆想、品味以及看客等心理相契合，有意或无意间受到网络世界的追捧，成为“网络红人”。因此，“网络红人”的产生不是自发的，而是网络媒介环境下，网络红人、网络推手、传统媒体以及受众心理需求等利益共同体综合作用下的结果。
斜挎包	斜挎包，顾名思义就是可以斜背的包。包已经不再是女士的专利，包也成了男士出门的随身物品之一，尤其是斜挎包，不仅方便而且大方。斜挎包的结构设计决定包的实用、耐用、舒适等很多方面的性能。
蓝牙	蓝牙技术是一种无线数据和语音通信开放的全球规范，它是基于低成本的近距离无线连接，为固定和移动设备建立通信环境的一种特殊的近距离无线技术连接。蓝牙使今天的一些便携移动设备和计算机设备能够不需要电缆就能连接到互联网，并且可以无线接入互联网。
条纹	条纹：塑料制品条纹：dc漫画英雄
折叠	折叠，读音为zhé dié，指的是一份词语。指把物体的一部分翻转和另一部分贴拢。指的是把物体的一部分折过来与另一部分挨在一起。把印好的书页折叠起来以便装订。
大衣	大衣（Coat）是一种常见的外套，衣䙓长度至腰部及以下。大衣一般为长袖，前方可打开并可以钮扣、拉链、魔鬼毡或腰带束起。具保暖或美观功效。在古代，大衣指代古代女性的礼服，名词起于唐代，沿用至明代。现在所称的西式大衣约在19世纪中期与西装同时传入中国。
单鞋	单鞋就是单层皮或单层布的鞋。单鞋的种类有很多，如休闲鞋、运动鞋、时装鞋，包括现在的一些靴子都是属于单鞋的类别。单鞋属于低帮鞋。
小吃	小吃是一类在口味上具有特定风格特色的食品的总称。小吃就地取材，能够突出反映当地的物质文化及社会生活风貌，是一个地区不可或缺的重要特色，更是离乡游子们对家乡思念的主要对象。世界各地都有各种各样的风味小吃，因当地风俗而异，特色鲜明，风味独特。现代人吃小吃通常不是为了吃饱，除了可以解馋以外，品尝异地风味小吃还可以藉此了解当地风情。
气质	盖伦最先提出了气质这一概念，用气质代替了希波克拉底体液理论中的人格，形成了4种气质学说，此分类方式一直在心理学中沿用至今。
双肩包	双肩包(Backpack)是对背在双肩的背包的统称。 根据双肩包不同的用途又分成，双肩电脑背包(Computer Backpack)，运动双肩包(Sports Backpack)，时尚双肩包(Fashion Backpack)，学校双肩包背(School Backpack)和束口绳包，军用背包(Military Backpack)，登山包等等。根据材质的不同又会成帆布包，牛津布包，尼龙布包。
中大童	百度百科是一部内容开放、自由的网络百科全书，旨在创造一个涵盖所有领域知识，服务所有互联网用户的中文知识性百科全书。在这里你可以参与词条编辑，分享贡献你的
旗舰店	旗舰店是指某一品牌在某城市中最大且最为丰富齐全的营业店，或拥有最快上市速度等特点为一体的专门店或专营店。
翻领	翻领（lapel〕汉语词汇，指翻在底领外面的领面造型。长袖或短袖都有翻领。区别于圆领，V字领，立领。
板鞋	“板鞋”是平地式板式的鞋。因为是玩滑板的人常穿的鞋，所以也称为滑板鞋。主要特点是鞋底要有缓冲功能，不一定要有气垫，鞋带有保护设计，防止磨断，鞋头最容易磨，需要很耐磨的材料，鞋舌厚，保护脚腕，还有很多讲究，在鞋垫上，鞋跟，鞋内里，各种特点，都是为了更好的运动效果，和更舒服的滑板感觉。
欧美	“欧美”是世界上的一块地域，其文化属于西方文化，是欧洲和北美的统称。主要是指欧洲全境、北美，以及澳大利亚和新西兰，统治血统为白人；有时也包括巴西、阿根廷、土耳其和以色列，因为这些国家由于历史原因，文化与欧洲渊源较深。西方世界主要特征为：国家的人民普遍享有宗教自由和言论自由，并得到法律保障，有民主选举，强调人权和法治。语言系统多使用拼音文字，拉丁字母或西里尔字母书写；文化上多承传历史悠久的
礼物	礼物是在社会交往中，为了表达祝福和心意或以示友好，人与人之间互赠的物品。礼物是送礼者向受礼者传递信息，情感，意愿的一种载体。通常是人和人之间互相赠送的物件，其目的是为了取悦对方，或表达善意、敬意。礼物也用来庆祝节日或重要的日子，比如情人节的玫瑰或生日礼物，不可不送。礼物也可以是非物质的，中国古代有“千里送鹅毛，礼轻情义重”的说法，表示礼物的价值在于送礼者的善意和心意，而非礼物本身的价值。礼物不需要太贵，只要表达了心意就可以了。
白色	白色是一种包含光谱中所有颜色光的颜色，通常被认为是“无色”的。白色的明度最高，无色相。可以将光谱中三原色的光：蓝色、红色和绿色，按一定比例混合得到白光。光谱中所有可见光的混合也是白光。这个颜色在当下代表纯洁。
苹果	苹果，是水果中的一种，是蔷薇科苹果亚科苹果属植物，其树为落叶乔木。苹果营养价值很高，富含矿物质和维生素，含钙量丰富，有助于代谢掉体内多余盐分，苹果酸可代谢热量，防止下半身肥胖。苹果是人们经常食用的水果之一。苹果是一种低热量食物，每100克产生60千卡热量。苹果中营养成分可溶性大，易被人体吸收，故有“活水”之称。它有利于溶解硫元素，使皮肤润滑柔嫩。
茶杯	茶杯是盛茶水的用具，水从茶壶而来，倒进茶杯，之后给客人品尝茶水。茶杯分大小两种：小杯主要用于乌龙茶的品啜，亦叫品茗杯，是与闻香杯配合使用
餐厅	餐厅就是指在一定场所，公开地对一般大众提供食品、饮料等餐饮的设施或公共餐饮屋。餐厅可能意指下列事物：餐馆（Restaurant），一种提供餐饮服务的店铺；饭厅（Dining Room），一种住宅建筑中通常会看到的房间/设施，有时会与厨房或客厅相连。
双人	双人,正如字面上的意思：两个人,也就是于自己配合时对自己的称呼。 
整箱	整箱也称整箱货(full container load简称：FCL) ，是货运代理中的专业术语。
早餐	早餐（breakfast/the morning meal），又叫早点、过早、早饭，是指在早上享用的餐。从中医养生角度讲，早上要补阳气，早餐要以谷类食物为主，可以加牛奶、粥等，当然，不管是哪一类的人，早餐都不提议吃腌的食物，因为腌的食物中可能存在着危险的物质——亚硝胺，会导致一些食道、肝的疾病。
运动裤	运动裤（英语trunks ，sport pants ，exercise pants，slacks ）比较专注于运动方面，对于裤子的材质方面有特殊的要求，一般来说，运动裤要求易于排汗，舒适，无牵扯，非常适合于激烈的运动。运动裤整体设计以及布料都有一定的科技含量，适合于夏天穿着。 运动裤的材质以尼龙、涤纶居多。
全自动	全自动是指机械装置和产品生产、加工操作的全面自动化。当前，随着计算机技术的高度普及，工业产品制造、零部件加工、人类社会生活产品等产业已全部进入到了由计算机可编程控制的全方位自动化生产时代。另外，在军工方面、航天设备、科研、农业、电力等行业也全部实施了由计算机辅助生产的全面自动化。也可以说，“全自动”一词的解释，也是在工农业生产中不靠人工而由机器装置自动操作的一种过程。
清新	清新区，清远市市辖区，位于粤北地区南部。清新区原为清新县，2012年12月撤销清新县，设立清远市清新区，以原清新县的行政区域为清新区的行政区域。位于广东省的西北部，北江中下游，隶属广东省清远市，是珠江三角洲与粤北山区的过渡地带距广州68公里，与香港、澳门距离不足200公里。总人口70万人，总面积2353平方公里。
静音	静音，日本漫画《火影忍者》及其衍生作品中的角色，火之国木叶隐村的优秀上忍，纲手早期的弟子之一，春野樱的师姐。性格低调、文静、温柔，且能力出众，擅长医疗忍术，是一位继承了纲手意志的医疗忍者。静音在第四次忍界大战中担任后勤部队——医疗部队的队长，发挥着重大作用。
家具	家具是指人类维持正常生活、从事生产实践和开展社会活动必不可少的器具设施大类。家具也跟随时代的脚步不断发展创新，到如今门类繁多，用料各异，品种齐全，用途不一。是建立工作生活空间的重要基础。
餐具	餐具指用餐时直接接触食物的非可食性工具，用于辅助食物分发或摄取食物的器皿和用具。目前市场上还出现了许多一次性的餐具，这种餐具对环境不好；也有一些可降解材料制作的餐具。餐具包括成套的，有金属器具、陶瓷餐具、茶具酒器、玻璃器皿、纸制器具、塑料器具以及五花八门、用途各异的各种容器类工具（如碗、碟、杯、壶等）和手持用具（如筷、刀、叉、勺、吸管、签棒等）及等用具。
成人	成人是指成年的人，即是已经完全发育成熟的人，与儿童相对。在大部份国家，成人的定义是年满18岁或以上的人，因此，一旦当地居民达至18岁，就可以享有各种相应的权利。
背心	中国魏晋南北朝时期的裲裆是背心的雏型，为敞领无袖束腰衣，仿自汉代的裲裆铠，取其“当背当心”之意（见图），宋代称作背心。至清代， 背心形制多样，有大襟、对襟、琵琶襟等，且男女皆可穿用。其中一种正胸饰一排13颗横纽的“巴图鲁（满语勇士）坎肩”，初用于朝廷要员，后也为一般官员穿用，士兵还将背心用作号衣。民国时期，劳动人民多将背心当作外衣穿。现代生活中穿用背心已十分普遍。背心一般按其制作材料命名，如皮背心、毛线背心等。它可做成单的、夹的，也可在夹背心中填入絮料。按絮料材质分别称棉背心、羊绒背心、羽绒背心等。
玻璃	玻璃是非晶无机非金属材料，一般是用多种无机矿物(如石英砂、硼砂、硼酸、重晶石、碳酸钡、石灰石、长石、纯碱等)为主要原料，另外加入少量辅助原料制成的。它的主要成分为二氧化硅和其他氧化物。 普通玻璃的化学组成是Na2SiO3、CaSiO3、SiO2或Na2O·CaO·6SiO2等，主要成分是硅酸盐复盐，是一种无规则结构的非晶态固体。广泛应用于建筑物，用来隔风透光，属于混合物。另有混入了某些金属的氧化物或者盐类而显现出颜色的有色玻璃，和通过物理或者化学的方法制得的钢化玻璃等。有时把一些透明的塑料（如聚甲基丙烯酸甲酯）也称作有机玻璃。
电视柜	电视柜主要是用来摆放电视的.随着人民生活水平的提高,与电视相配套的电器设备相应出现，导致电视柜的用途从单一向多元化发展，不再是单一的摆放电视用途，而是集电视、机顶盒、DVD、音响设备、碟片等产品收纳和摆放。更兼顾展示的用途。电视柜是家具中的一个种类，因人们不满足把电视随意摆放而产生的家具，也有称为视听柜。电视柜还有客厅组合柜等等。
电脑	计算机（computer）俗称电脑，是现代一种用于高速计算的电子计算机器，可以进行数值计算，又可以进行逻辑计算，还具有存储记忆功能。是能够按照程序运行，自动、高速处理海量数据的现代化智能电子设备。由硬件系统和软件系统所组成，没有安装任何软件的计算机称为裸机。可分为超级计算机、工业控制计算机、网络计算机、个人计算机、嵌入式计算机五类，较先进的计算机有生物计算机、光子计算机、量子计算机等。计算机发明者约翰·冯·诺依曼。计算机是20世纪最先进的科学技术发明之一，对人类的生产活动和社会活动产生了极其重要的影响，并以强大的生命力飞速发展。它的应用领域从最初的军事科研应用扩展到社会的各个领域，已形成了规模巨大的计算机产业，带动了全球范围的技术进步，由此引发了深刻的社会变革，计算机已遍及一般学校、企事业单位，进入寻常百姓家，成为信息社会中必不可少的工具。计算机的应用在中国越来越普遍，改革开放以后，中国计
储物柜	产品定义储物柜一般分为家庭储物柜和商务储物柜等，主要用来方便人们的使用，存储不同的物品，分门别类。而且对于空间较小的家庭或者宿舍来说，更是必备物品，能够充分利用好空间来容纳较多的生活物品，而且也能够很好的装饰人们的居家环境。
收纳盒	装东西的盒子，也就是将东西（多指小件物品，如：办公文具、化妆品、文件资料、小工具、袜子、裤衩等）收集集中起来，顾名思义就叫收纳盒。
即食	百度百科是一部内容开放、自由的网络百科全书，旨在创造一个涵盖所有领域知识，服务所有互联网用户的中文知识性百科全书。在这里你可以参与词条编辑，分享贡献你的
半身裙	半身裙（Skirt）是指所有穿着在下装的单独的裙装样式，包括长裙、短裙、铅笔裙、A字裙等等。半身裙给我们的第一感觉就是OL套装的窄裙。半身裙是十分多变百搭的，选择不一样的衣衫就能穿出不一样的风情。半身裙不仅能满足职场的知性优雅装扮，还能满足你约会的甜美可爱装扮，展现属于你的着装精彩。
系带	系带是一个汉语词汇，就是指主要用于捆扎包装物的窄形织品。生活中随处可见系带物品比如鞋带、各种绳子、甚至人体内部都有很多系带。
哈伦	哈伦：古代先知哈伦：丹麦足球运动员哈伦：魔幻喜剧《幻想殷商》人物
卫生间	卫生间就是厕所、洗手间、浴池的合称。住宅的卫生间一般有专用和公用之分。专用的只服务于主卧室；公用的与公共走道相连接，由其他家庭成员和客人公用。根据布局可分为独立型、兼用型和折中型三种。根据形式可分为半开放式、开放式和封闭式。目前比较流行的是区分干湿分区的半开放式。
健身	健身是一种体育项目，如各种徒手健美操、韵律操、形体操以及各种自抗力动作，体操可以增强力量、柔韧性，增加耐力，提高协调，控制身体各部分的能力，从而使身体强健。如果要达到缓解压力的目的，至少一周锻炼3次。游泳、快走、慢跑、骑自行车，及一切有氧运动都能锻炼心脏。有氧运动好处多：能锻炼心肺、增强循环系统功能、燃烧脂肪、加大肺活量、降低血压，甚至能预防糖尿病，减少心脏病的发生。美国运动医学院建议，想知道有氧运动强度是否合适，可在运动后测试心率，以达到最高心率的60%—90%为宜。如果想通过有氧运动来减肥，可以选择低度到中度的运动强度，同时延长运动时间，这种方法消耗的热量更多。运动频率每周3—5次，每次20—60分钟。想要锻炼肌肉，可以练举重、做体操以及其他重复伸、屈肌肉的运动。肌肉锻炼可以燃烧热量、增强骨密度、减少受伤，尤其是关节受伤的几率，还能预防骨质疏松。 在做举重运动前，先测一下，如果连续举8
两件套	百度百科是一部内容开放、自由的网络百科全书，旨在创造一个涵盖所有领域知识，服务所有互联网用户的中文知识性百科全书。在这里你可以参与词条编辑，分享贡献你的
布艺	布艺 即指布上的艺术，是古时期中国民间工艺中的一朵瑰丽的奇葩。中国古代的民间布艺主要用于服装，鞋帽，床帐，挂包，背包和其他小件的装饰（如头巾，香袋，扇带，荷包，手帕等），玩具等。以布为原料，集民间剪纸，刺绣，制作工艺为一体的综合艺术。如动植物身上的装饰性花卉等，都是通过剪和绣的工艺制作而成。布艺品的分类方法有很多，如按使用功能、空间、设计特色、加工工艺等分类。不管用什么材料和加工工艺制作的布艺品，最重要的是用在什么地方和做什么用，所以我们通常把布艺品按照使用功能和空间分类。
超薄	百度百科是一部内容开放、自由的网络百科全书，旨在创造一个涵盖所有领域知识，服务所有互联网用户的中文知识性百科全书。在这里你可以参与词条编辑，分享贡献你的
棉鞋	英文名cotton-padded shoes是鞋类的一种，是用棉花、动物皮毛、等物品做内衬，让人们在冬天能够保护足部不被冻伤。鞋帮和鞋底中间填有棉花等保温材料用以御寒的鞋。多为手工制品，也有机械制作的，但穿的舒适性要差一些。棉鞋不在像以前那样单一了，款式新潮，颜色艳丽多彩，棉鞋既美观又保暖，适合搭配各类衣服及家居穿着。
棉麻	棉麻是指棉和麻为原材料的纺织品，棉和麻都是温带的植物生长出来的分别有棉花和蓖麻的种子部分采下来，经过晒干，机器脱粒，分解出种子和棉麻部分，经过机器压制，在经过纺织成线，布匹，最后经过染制，成品。埃及人最早发现使用亚麻纤维，有8000的年的历史，中国在4000年前的新石器时期以发现使用苎麻作纺织原料。
女孩	女孩泛指年轻的女性人类。指从一个婴儿变成一名成年女人的过渡阶段，在不同的社会各不相同，但基本上都认为是青少年期至成年期的转变，年龄通常在0岁至22岁之间。
春装	春季穿的服装由于春装与其它季节的服装并没有绝对的界限，不同地方的气温也都相差很大，所以严格界定春装的范围实际上很困难，主要靠人们自己的感觉。春季与秋季的温度较接近，所以有时将这两个季节的服装统称为春秋装。
礼盒装	百度百科是一部内容开放、自由的网络百科全书，旨在创造一个涵盖所有领域知识，服务所有互联网用户的中文知识性百科全书。在这里你可以参与词条编辑，分享贡献你的
官方	官方，词语，有多种释义。一般解释为政府方面，古代指设官府。又指掌控权利的一方，例如公司的“官方”，“官网”则是官方网站。另外也指，某一方说的什么都是有理由的，没有不对的地方。官方是指举办某场社会活动事件的组织者，或某种商业产品的推广经营者，即主办方，是一个直接面对消费者的团体组织或企业。主办方具有权威性，有着制定力。简而言之，官方对于某指定生产商品有着最大解释权和定义权，对于该商品来说，官方信息也是最具权威、正确的信息。现代商业中，企业以广告赞助的方式，取得某场活动的指定消费品，例如：官方用车，官方指定饮料等，以达到品牌推广及销售的目的。
羽绒	羽绒是长在鹅、鸭的腹部，成芦花朵状的绒毛，成片状的叫羽毛。由于羽绒是一种动物性蛋白质纤维，羽绒球状纤维上密布千万个三角形的细小气孔，能随气温变化而收缩膨胀，产生调温功能，可吸收人体散发流动的热气，隔绝外界冷空气的入侵。从蓬松度的检测上来分析，羽绒比蚕丝，棉花等保暖材料都要高一个等级，比如最低标准的450度蓬松的90鸭绒也要比蚕丝和棉花蓬松好，所以羽绒单纯作为一个保暖材料，它的经济价值远远高于其他保暖材料
双面	《双面》，是莫文蔚第一首个人创作曲，由音乐才女黄韵玲制作。拍手的节奏与自由的随意吟唱互相呼应，别开生面。
女中	百度百科是一部内容开放、自由的网络百科全书，旨在创造一个涵盖所有领域知识，服务所有互联网用户的中文知识性百科全书。在这里你可以参与词条编辑，分享贡献你的
工装	工装是为工作需要而特制的服装。在设计上，根据客户的要求，结合职业特征、团队文化、年龄结构、体型特征、穿着习惯等，从服装的色彩、面料、款式、造型、搭配等多方面考虑，提供最佳设计方案，为顾客打造富于内涵及品位的全新职业形象。另指装修的另一分类，即装修两大块之一，家装、工装。
帆布鞋	帆布鞋是一种兴起于欧洲的厚胶底，鞋面覆帆布的鞋。因穿着轻便，耐穿，价格低廉广受世界各地人民欢迎。款式主要有高帮、低帮。
拉链	拉链（zipper） 是依靠连续排列的链牙，使物品并合或分离的连接件，现大量用于服装、包袋 、帐篷等。
西装	西装又称作“西服”、“洋装”。西装是一种“舶来文化”，在中国，人们多把有翻领和驳头，三个衣兜，衣长在臀围线以下的上衣称作“西服”，这显然是中国人民对于来自西方的服装的称谓。
餐桌	餐桌的原意，是指专供吃饭用的桌子。按材质可分为实木餐桌、钢木餐桌、大理石餐桌、大理石餐台、大理石茶几、玉石餐桌、玉石餐台、玉石茶几、云石餐桌等。另外，是在网络上，人们对于生活不满的发泄，比较多的用在魔兽世界游戏中。形象的比喻为：我们的人生就像是餐桌，上面摆满了杯具（悲剧）和餐具（惨剧）。
茶壶	茶壶（英文：teapot），是一种泡茶和斟茶用的带嘴器皿。它是茶具的一种，主要用来泡茶。茶壶由壶盖、壶身、壶底、圈足四部分组成，壶盖有孔、钮、座、盖等细部。壶身有口、延（唇墙）、嘴、流、腹、肩、把（柄、扳）等部分。由于壶的把、盖、底、形的细微差别，茶壶的基本形态就有200种。泡茶时，茶壶大小依饮茶人数多少而定。茶壶的质地很多，目前使用较多的是以紫砂陶壶或瓷器茶壶。相关经典名句：“一器成名只为茗，悦来客满是茶香。”
室内	室内，卧室 室内 英文名：indoor 1.谓祖庙之内。室，指太室。《史记·楚世家》：“初， 共王 有宠子五人，无适之，乃望祭羣神，请神决之，使主社稷，而阴与 巴姬 埋璧於室内，召五公子斋而入。” 2.家中。《列子·杨朱》：“﹝ 公孙朝 ﹞不知世道之安危，人理之悔吝，室内之有亡，九族之亲疏，存亡之哀乐也。” 宋 陈鹄 《耆旧续闻》卷十：“ 放翁 先室内琴瑟甚和，然不当母夫人意，因出之。夫妇之情实不忍离。” 3.[indoor] 一所建筑物的内部,由6个面组成。 随着工业的飞速发展，同时人类的物质也在不段的提高，也推动了室内装饰这一块的提高。 
裙子	裙子指一种围在腰部以下的服装。裙装是一种围于下体的服装，也是下装的基本形式之一。广义的裙子还包括连衣裙、衬裙、短裙、裤裙、腰裙。裙一般由裙腰和裙体构成，有的只有裙体而无裙腰。它是人类最早的服装。因其通风散热性能好，穿着方便，行动自如，美观，样式变化多端诸多优点而为人们所广泛接受，其中以女性和儿童穿着较多。
帅气	漂亮；英俊；酷；使人惊艳的。可用来形容人物或事，形容人物时多指男性。
秋冬装	百度百科是一部内容开放、自由的网络百科全书，旨在创造一个涵盖所有领域知识，服务所有互联网用户的中文知识性百科全书。在这里你可以参与词条编辑，分享贡献你的
春季	四季之一。从节气意义上讲，春季的开始是在立春（2月2日至5日之间），春季的结束在立夏（5月5日至7日之间）。在欧美，春季从中国的春分开始，到夏至结束。在爱尔兰，2月~4月被定为春季。气象工作者就研究出一种尽量符合自然景象的四季划分标准，以5天平均气温为标准，把冬季以后五天平均气温稳定通过10℃时开始进入春季，当温度高于22℃时意味着春季的结束夏季的开始。
12	12（十二）是介于11与13之间两位数、自然数，是一个偶数，因数有1、2、3、4、6和12。日常算数单位中，12个也叫做一打。
10	10，相当于汉字"十"，是位于9与11之间的自然数、正整数，是一个自然数。在十进制中，10是最小的两位数。写法是一个1后面加一个0，是一个合数，有4个因数（约数），是一个有理数。
格子	格子就是将网站首页划分成若干小格子放置别人的图片，或者出售，你买下来后可以在上面放上广告或者其他信息。说到格子就要提到把格子发扬光大的英国一个大学生。
特价	特价，特别优惠的价格、特别低廉价格的简称。就是一种比市场价格要低的一种商品的价格，它普遍存在于商业中的各种营销活动中，是各种经济体营销的重要的手段之一。以较市场价偏低的价格，以接近成本价的价格，在同种商品中脱颖而出，对消费者更具有吸引力，更有号召力，从而，占有更大的市场份额。成规模的商家往往主打价格优势，以特价的形式，赢得自己的市场空间，在竞争激烈的市场空间中，薄利多销成为众多商家制胜的法宝。2017年12月1日，《公共服务领域英文译写规范》正式实施，规定特价标准英文名为Special Offer。
田园	田沅，1985年3月30日出生于湖北省武汉市，中国内地影视女演员、歌手、导演、作家。2001年，16岁的田沅便加入跳房子乐队担任主唱。2002年，田沅凭借个人首张音乐专辑《A Wish-ful Way》获得中国摇滚总评中国最具国际化魅力女歌手称号；同年，她还出版了个人首部长篇小说《斑马森林》。2005年，田沅凭借个人电影处女作《蝴蝶》获得第24届香港金像奖最佳新人奖。2008年，田沅主演了喜剧片《高兴》。2011年，她将工作重心转向导演领域，并执导了《盲糖》等十几部微电影作品。2014年，其主演的剧情片《黄金时代》在国内院线全面上映。
呢大衣	网站简介呢大衣，创立于2012年，主要为广告城市爱美女性提供一个选购服的平台，网站主要针对呢大衣这类衣服进行衍生，主要有呢子大衣，呢子外套，毛呢大衣，毛呢外套，毛呢大衣品牌，羊毛呢大衣，毛呢裙等各类呢类款衣服，让大家在家上网就能找到自己喜欢的呢大衣！网站分类女式呢大衣 毛呢裙网站宗旨方便广大女性用户能够快捷的发现与购物自己喜欢的呢大衣服务群体爱美追求时尚的年轻城市女性 
女包	女包，这个名词是箱包的性别分类衍生词。有性别区分并仅限于符合女性审美观的箱包统称为女包。女包也是女性的随身装饰品之一。按照国内的分类来说，一般按照功能来分：短款钱包、长款钱包、化妆包、晚装包、手提包、单肩包、双肩包、斜挎包、旅行包、胸包以及多功能包。
充电	充电是一个汉语词汇，指给蓄电池等设备补充电量的过程。其原理是让直流电从放电相反的方向通过，以使蓄电池中活性物质恢复作用。它有引申义比如学习，工作等。
阳台	是建筑物室内的延伸，是居住者呼吸新鲜空气、晾晒衣物、摆放盆栽的场所，其设计需要兼顾实用与美观的原则。阳台一般有悬挑式、嵌入式、转角式三类。阳台不仅可以使居住者接受光照、吸收新鲜空气、进行户外锻炼、观赏、纳凉、晾晒衣物，如果布置得好，还可以变成宜人的小花园，使人足不出户也能欣赏到大自然中最可爱的色彩，呼吸到清新且带着花香的空气。
水壶	水壶，是一种盛水的容器。有很多种材质，可以指烧水用的金属壶，也可以指便于携带的饮用水壶，主要分为五大类：1、塑料的（主要材料）2、不锈钢的3、铝合金的4、陶瓷的5、其它材质的，可由电加热也可直接用火加热。
夏装	夏季穿着清凉避暑的服装，称夏装。一般指短袖，背心，短裤，裙子等比较凉快透气的服装服饰．
拖鞋	拖鞋是鞋子的一种，后跟全空，只有前面有鞋头，多为平底，材质经常是相当轻软的皮料、塑料、布料等。拖鞋种类依穿着场合及性能用途有所区分。例如海滩拖鞋，就不会是布料制，而是塑料，这是为了要防水，好清洗的缘故，鞋头型式也经过特别设计，常被称为夹脚拖鞋，也就是我们所说的人字拖。但冬天的室内拖鞋，则为了保暖，可能使用绒毛布，而不使用塑料，使人们在居室内有更好的享受。另有电子厂及无尘车间常用的防静电拖鞋。
棒球	棒球是一种以棒打球，以团队性、对抗性为显著特征的球类运动项目。棒球在国际上开展广泛，主要流行于美国、日韩，以及拉丁美洲和中国的台湾地区。棒球是一种团体性体育运动，比赛人数最少为9人，近似运动项目为垒球。棒球球员分为攻、守两方，利用球棒和手套，在一个直角扇形的棒球场里进行比赛。比赛时，两队轮流攻守：当进攻球员成功跑回本垒，就可得1分。比赛共有9局，得分高的一队胜。第9局结束双方打平就会进入延长局，直至分出胜负。棒球从1992年巴塞罗那奥运会开始成为正式比赛项目，但2012伦敦奥运会开始不再作为比赛项目，2020年东京奥运会，棒球重新成为比赛项目。另外，奥运会棒球只设男子项目。
单人	《单人》是由潘成、小昔米作词，潘成作曲，杨云祥编曲，江安缩混，朱元冰演唱的一首歌曲。
平底	平底是陶瓷容器底部形式之一。即整个底面比较平坦，无明显起伏。有轻微弧凹的底形也属平底范畴。
性感	性感是一个汉语词汇，指某个人的文化气质、 身材相貌或穿着打扮或动作，唤醒他人“感性意识认知的魅力美”。“性感”即能对他人具有亲和力以致引起他人爱恋的感觉。性感这个概念还包括着一种极具个性的气质，一股能够吸引别人的个人魅力和一份可以恰到好处地展现内在和自身优势的智慧。性感可指很多方面，身材、衣着、外貌、发型、谈吐、表情、姿势等。
三件套	百度百科是一部内容开放、自由的网络百科全书，旨在创造一个涵盖所有领域知识，服务所有互联网用户的中文知识性百科全书。在这里你可以参与词条编辑，分享贡献你的
经典	经典读音jīngdiǎn英文名classics:指具有典范性、权威性的；经久不衰的万世之作；经过历史选择出来的“最有价值经典的”;最能表现本行业的精髓的；最具代表性的；最完美的作品。
文艺	文艺 Literature and art：文学和艺术，有时指文学或表演艺术，是人们对生活的提炼，升华和表达。文艺的开始意味着人类的文艺复兴，人类将重新发现了人和人格的伟大，肯定了人的价值和能力，提出人要养育人格，个性应该智慧；一致幸福的求实精神，对人首先要研究个究竟，决不满足于对其他事物的一知半解，为创造现实幸福生活而奋斗的乐观进取精神，把人从以往历史、民族、宗教、地域等诸多划分的桎梏下解放出来。
现货	现货（Actuals）也称实物（physicals），指可供出货、储存和制造业使用的实物商品。可供交割的现货可在近期或远期基础上换成现金，或先付货，买方在极短的期限内付款的商品的总称。现货是期货的对称。
保温杯	保温杯（Vacuum cup）一般是由陶瓷或不锈钢加上真空层作成的盛水的容器，顶部有盖，密封严实，真空绝热层能使装在内部的水等液体延缓散热，以达到保温的目的。保温杯从保温瓶发展而来的，保温原理与保温瓶一样，只是人们为了方便把瓶做成杯。
内衣	内衣（英文名：Underwear）是指贴身穿的衣物，包括肚兜、汗衫(长袖、短袖、背心)、短裤、抹胸、胸罩等，通常是直接接触皮肤的，是现代人不可少的服饰之一。内衣有吸汗、矫型、衬托身体、保暖及不受来自身体的污秽的危害的作用，有时会被视为性征。
浴室	《浴室》是2006年由南海出版社出版的图书，作者是深圳市金版文化发展有限公司。《浴室》是《餐厨卫浴设计系列》的其中一本，书中包含设计方案、知识介绍、100个客厅案例，100条装修知识，为读者提供全面的装修知识。
神器	神器【拼音】shénqì 【解释】 1.犹言神物。《老子》：“将欲取天下而为之，吾见其不得已。天下神器，不可为也。为者败之。” 王弼 注：“神，无形无方也，器，合成也，无形以合，故谓之神器也。” 2.代表国家政权的实物，如玉玺、宝鼎之类。借指帝位、政权。《汉书·叙传上》：“世俗见 高祖 兴于布衣，不达其故，以为适遭暴乱，得奋其剑，游说之士至比天下於逐鹿，幸捷而得之，不知神器有命，不可以智力求也。” 颜师古 注引 刘德 曰：“神器。玺也。”《文选·左思〈魏都赋〉》：“ 刘 宗委驭，巽其神器。” 吕延济 注：“神器，帝位。” 唐 杜甫 《送从弟亚赴河西判官》诗：“经纶皆新语，足以正神器。” 仇兆鳌 注引《汉书注》：“神器，政令也。”《三国演义》第八十回：“ 曹氏 大骂曰：‘吾父功盖寰区，威震天下，然且不敢篡窃神器。’” 曹亚伯 《武昌革命真史·武昌起义·檄各府州县电》：“窥窃我神器，诛锄我人民
系列	系列是汉语词语，拼音xìliè，是指相互关联的成组成套的事物或现象。出自柯岩《船长》：“我们可以采取改变航向、变更航速、减轻正面迎风及开慢车等一系列技术措施嘛！” 陈原《社会语言学·语言作为一种社会现象》：“语言属于社会现象的系列时，意味着什么呢？”。
舒适	舒适（1916年4月19日——2015年6月26日），男，原名舒昌格，浙江慈溪人。持志大学肄业。1938年后任青鸟剧社、上海大同摄影场、金星影片公司演员和编导。1952年后任上海电影制片厂演员、导演，中国影协第三、四届理事。曾主演《林冲》、《水上春秋》，在《红日》中饰演张灵甫而家喻户晓。导演过《绿海天涯》等影片。2015年6月26日，舒适去世，享年99岁。
皮衣	皮衣是采用动物皮经过特定工艺加工成的皮革做成的衣服，主要作用是防寒，皮衣采用的制作原料有牛皮、羊皮、蛇皮、鱼皮等动物皮。皮衣皮质柔软，没有残疵点，色彩均匀，没有明显色差，有光泽，颜色协调。皮革及其制品的市场潜力是很大的，全球皮革总需求量约为1.0亿平方米，相当于3亿张牛皮（标准皮）的产量，中国皮革产量折合标准皮近7000万张，约占全球皮革产量的23.33%。
韩版潮	百度百科是一部内容开放、自由的网络百科全书，旨在创造一个涵盖所有领域知识，服务所有互联网用户的中文知识性百科全书。在这里你可以参与词条编辑，分享贡献你的
男孩	《男孩》是梁博演唱的歌曲，由梁博创作词曲并编曲，并由梁博在湖南卫视《歌手2017》首演。
四季	指一年中交替出现的四个季节，即春季、夏季、秋季和冬季。在天文上，季节划分是以地球围绕太阳公转轨道上位置确定的。当地球在一年中不同的时候，处在公转轨道的不同位置时，地球上各个地方受到的太阳光照是不一样的，接收到太阳的热量不同，产生季节的变化和冷热的差异。地球上的四季不仅是温度的周期性变化，而且是昼夜长短和太阳高度的周期性变化。它影响或者决定地球环境中很多事物的运动节律，尤其是生物适应最为明显。
文胸	胸罩（Brassiere）是女性使用的内衣之一，又称奶头布、乳罩、乳房罩，奶罩或文胸等，功能是用以遮蔽及支撑乳房。“胸罩”一词据说第一次出现在1907年，那年美国版的时尚杂志《VOUGE》印有这个"bra"字眼，"bra"（胸罩）这个词并于1911年被正式载入牛津词典。胸罩起源说法不一，但多认为源自法国，称之为“Brassière”（简称为“Bra”）。中世纪的欧洲贵族流行穿一种非常紧身的束衣，后来因束衣太麻烦，改用两条手帕制成胸衣，成为了现代胸罩的雏型。
毛领	百度百科是一部内容开放、自由的网络百科全书，旨在创造一个涵盖所有领域知识，服务所有互联网用户的中文知识性百科全书。在这里你可以参与词条编辑，分享贡献你的
装饰品	装饰品是可以起到修饰美化作用的物品，比如装修效果图造型的轮廓和雕刻装饰；或在身体或物体的表面加些附属的东西，使之更美观。装饰品可以起到点缀和衬托的作用。
吊灯	吊灯是指吊装在室内天花板上的高级装饰用照明灯。吊灯无论是以电线或以铁支垂吊，都不能吊得太矮，阻碍人正常的视线或令人觉得刺眼。以饭厅的吊灯为例，理想的高度是要在饭桌上形成一池灯光，但又不会阻碍桌上众人互望的视线。现时吊灯吊支已装上弹簧或高度调节器，可适合不同高度的楼底和需要性。
婴幼儿	婴儿和幼儿的统称，一般是指0-3岁的小龄孩子。婴儿与幼儿之间有莫大的联系，因此在许多的儿童论著、医学论著、儿童早期教育等会将它们并起来说，以示方便理解。虽然它们之间有着密切的联系，但如果从孩子发展层面来说还是有两个方面区别，一为婴儿（0-1岁）和幼儿（1-3岁）。婴幼儿是一个受护群体，饮食方面尤为重要，婴儿以母乳为主食（4-6个月后逐渐添加辅食），1岁后以成人食物为主食。
壁挂	挂在墙壁上的一种装饰性织物。包括毛织壁挂、印染壁挂、刺绣壁挂、棉织壁挂等。毛织壁挂也叫壁毯、挂毯。
马丁	乔治·雷蒙德·理查德·马丁（George Raymond Richard Martin），通常被称为乔治·R·R·马丁或GRRM，是一名擅长撰写奇幻、科幻和恐怖小说题材的美国作家、编辑、电视剧编剧兼制片人，雨果奖、星云奖、轨迹奖、世界科幻奖等文学奖项的多次得主。马丁的作品主要以人物为关注点，描写细腻丰富，突破了幻想文学界固有的创作模式，多次引领阅读潮流。代表作有十大浪漫太空歌剧之一的《光逝》、由雨果奖获奖名篇扩展而成的《风港》、在杂志读者群中深受爱戴的《图夫航行记》，以及当代严肃奇幻的经典《冰与火之歌》（A Song of Ice and Fire）系列等。由于马丁作品的辉煌成就，他被《时代》杂志誉为“美国的托尔金”和“新世纪的海明威”。
春秋季	百度百科是一部内容开放、自由的网络百科全书，旨在创造一个涵盖所有领域知识，服务所有互联网用户的中文知识性百科全书。在这里你可以参与词条编辑，分享贡献你的
水果	水果，是指多汁且主要味觉为甜味和酸味，可食用的植物果实。水果不但含有丰富的维生素营养，而且能够促进消化。
杯子	杯子，（一种专门盛水的器皿）从古至今其主要功能都是用来饮酒或饮茶。在古代喝茶的杯子被称为盖碗。基本器型大多是直口或敞口，口沿直径与杯高近乎相等。有平底、圈足或高足。考古资料表明最早的杯始见于新石器时代。无论是在仰韶文化、龙山文化还是河姆渡文化遗址中都见有陶制杯的存在，这一时期杯型最为奇特多样：带耳的有单耳或双耳杯、带足的多为锥形、三足杯、觚形杯、高柄杯等等，根据制作材料不同，可以分为玻璃杯、塑料杯、陶瓷杯、木杯等。
益智	益智（拉丁学名：Alpinia oxyphylla Miq.），别名：益智仁、益智子。姜科，山姜属多年生草本植物。株高可达3米；茎丛生；根茎短，叶片披针形，总状花序在花蕾时全部包藏于一帽状总苞片中，花时整个脱落，花序轴被极短的柔毛；花萼筒状，花冠白色，外被疏柔毛；唇瓣倒卵形，粉白色而具红色脉纹，蒴果鲜时球形，干时纺锤形，种子不规则扁圆形，被淡黄色假种皮。果实椭圆形，两端略尖，表面棕色或灰棕色，有纵向凹凸不平的突起。果皮薄而较韧，与种子团紧贴。种子团被隔膜分为3瓣，每瓣有种子6-11粒。种子呈不规则的扁圆形，略有钝棱，直径约3mm，表面灰褐色或灰黄色，外被淡棕色膜质的假种皮。花果期3～9月。生长于阴湿林下。分布海南及广东南部。夏、秋间果实由绿变红时采收，晒干或低温干燥。有特异香气，味辛、微苦。果实供药用，有益脾胃，理元气，补肾虚滑沥的功用。治脾胃（或肾）虚寒所致的泄泻，腹痛，呕吐，食欲不振，
耳机	耳机(Earphones; Headphones; Head-sets; Earpieces)是一对转换单元，它接受媒体播放器或接收器所发出的电讯号，利用贴近耳朵的扬声器将其转化成可以听到的音波。耳机一般是与媒体播放器可分离的，利用一个插头连接。好处是在不影响旁人的情况下，可独自聆听音响；亦可隔开周围环境的声响，对在录音室、酒吧、旅途、运动等在噪吵环境下使用的人很有帮助。耳机原是给电话和无线电上使用的，但随着可携式电子装置的盛行，耳机多用于手机、随身听、收音机、可携式电玩和数位音讯播放器等。从整个音频行业的发展来看，无线耳机仍然算是新生事物，发展时间并不长，目前仍处在上升期，用户需求不断提升，用户对无线耳机的期望值也在提高，这就是对行业提出的新的考验。目前用户最关心的几个要点包括音质、续航能力和无线传输能力，从数据上来看，无线传输能力基本已经可以满足绝大多数用户的需求，而音质和续航能力还有
德国	德意志联邦共和国（德语：die Bundesrepublik Deutschland），简称德国（两德统一前简称西德或联邦德国），是位于中欧的联邦议会共和制国家，北邻丹麦，西部与荷兰、比利时、卢森堡和法国接壤，南邻瑞士和奥地利，东部与捷克和波兰接壤，该国由16个联邦州组成，首都为柏林，领土面积357167平方公里，以温带气候为主，人口约8267万人，是欧洲联盟中人口最多的国家，以德意志人为主体民族。 德国人的祖先是古代居住在中欧的日耳曼人。10世纪时日耳曼人建立神圣罗马帝国，后发生分裂。1871年普鲁士王国吞并除
用品	用品：指一些人类所能够使用东西及类品，例如：生活用品，洗车用品，保洁用品，婴幼儿用品等等．这些都可以归类为用品种类．
防风	防风（Saposhnikovia divaricata (Trucz.) Schischk.）多年生草本，根粗壮，细长圆柱形，淡黄棕色。茎单生，自基部分枝较多，与主茎近于等长，有细棱，基生叶丛生，有扁长的叶柄，基部有宽叶鞘。叶片卵形，有柄。茎生叶与基生叶相似，但较小，顶生叶简化，有宽叶鞘。复伞形花序多数，生于茎和分枝，顶端花序梗长2-5厘米；伞辐无毛；小伞形花序有花4-10；无总苞片；小总苞片线形，先端长约3毫米，萼齿短三角形；花瓣倒卵形，白色，无毛。双悬果狭圆形，幼时有疣状突起，成熟时渐平滑；花期8-9月，果期9-10月。产中国黑龙江、吉宁、辽宁、内蒙古、河北、宁夏、甘肃、陕西、山西、山东等省区。生长于草原、丘陵、多砾石山坡。根供药用，用于治感冒、头痛、周身关节痛、神经痛等症。（概述图片来源：）
过膝	百度百科是一部内容开放、自由的网络百科全书，旨在创造一个涵盖所有领域知识，服务所有互联网用户的中文知识性百科全书。在这里你可以参与词条编辑，分享贡献你的
睡衣	睡衣早已成为西方生活方式的象征。说到这个词的起源，你也许会大跌眼镜，因为如此“洋味”十足的东西竟是个地道的外来词。原词paejama来自北印度语，它由波斯语中的pai和jamah两个词组合而成。pai在波斯语中表示“腿”，而jamah表示“衣服”。pajamas顾名思义就是腿部的服装——裤子。这本是一种中东和印度人外出穿的宽松裤子，然而欧洲殖民者们别出心裁赋予了它新的作用——睡裤。
双层	百度百科是一部内容开放、自由的网络百科全书，旨在创造一个涵盖所有领域知识，服务所有互联网用户的中文知识性百科全书。在这里你可以参与词条编辑，分享贡献你的
水洗	摄影中在冲卷和放照片是显影后有一步水洗过程这里是讲把底片或相纸放在装满水的容器里洗掉上边的药水免得在下一步时和其他药品发生化学反应。还有很多行业利用到水洗。
靴子	しゅーず（shoose），于2009年10月在日本大型人气网站ニコニコ动画（niconico动画）活动的人气歌い手（唱见）。以具有磁性且清澈的声线著称，辨识度极强，能游刃有余地驾驱各种曲风。初投稿曾获得「疲劳系男子」的称号，但到了后期他的唱法又有了很大改变和进步。感情的爆发经常会使用哭腔，以至于他的曲子具有惊人的中毒性。翻唱时多与あいす（aisu）合作，和他在C86以组合しゅーあいす的名义发布了专辑空想カプセル。和38番、ココヤシ、わたあめ、茶绪、にっとメガネ以「なつうた（夏天的歌）」的名义实行「怀旧曲试唱计划」。投稿过宅舞视频，和オトメン与Moz组成黒ゐ明太子的舞蹈组合，除此之外还参加过两个舞蹈视频投稿。除了「なつうた」中的人外，和ギガP(GigaP)、オトマン、茶绪、れをる（reol）等人关系良好，很喜欢ジミーサムP。生放送完成度极高，live中的口碑也很好。于2015年11月4日发行
春夏	春夏，1992年12月5日出生于云南省昆明市，中国内地影视女演员、平面模特。2013年，出演个人首部电视剧《我心灿烂》，从而正式进入演艺圈。2014年，主演都市情感轻喜剧《我的博士老公》；同年，出演个人首部电影《踏血寻梅》，在片中饰演女主角王佳梅。2015年，凭借电影《踏血寻梅》获得“第19届富川国际奇幻电影节”最佳女主角奖。2016年4月3日，凭借电影《踏血寻梅》获得“第35届香港电影金像奖”最佳女主角奖；同年，主演青春爱情电影《完全男生手册》武侠电影《刀背藏身》。2018年，其主演的奇幻冒险电影《怪物先生》正式杀青；11月13日，其主演的警匪电影《限期破案》开机。
旅行	旅行，指远行；去外地办事或游览。去外地行走。不同于旅游。旅行和旅游的区别就在于：旅行是在观察身边的景色和事物，行万里路，读万卷书，相对于是指个人，是行走。旅游是指游玩，通常是团体出行，在时间上是很短暂的。旅游就是旅行游览活动。它是一种复杂的社会现象，旅行要涉及到社会的政治、经济、文化、历史、地理、法律等各个社会领域。旅游也是一种娱乐活动，任何去外地游玩都可以算。世界旅游组织指旅行的定义是某人出外最少离家55英里（88.5千米）。
高帮	high-layer 指砂层位于水面以上垂直高度。 当工业指标中有盖层剥离比要求时，非含目的矿物砂粘土层称高帮；工业指标为混合砂时称干帮。1 另指鞋袜筒的高度比较高 
天然	天然，拼音tiān rán，释义：自然生成的，自然形成的(区别于人工、人造)；指事物不加修饰的本色；指诗文书画等的自然风致和情趣；理所当然，自然而然；指天性、本性；自然赋予的，生来具备的。出自《史记·平津侯主父列传》：“臣窃以为陛下天然之圣，宽仁之资，而诚以天下为务，则 汤 武 之名不难侔，而 成 康 之俗可复兴也。”
落地	落地，指婴儿出生，指物体的下端直达地面，物体落到地上或声音停止等意义。古义原指科举时代应试不中。出自晋 陶潜《杂诗》之一。
防晒	防晒是指为达到防止肌肤被晒黑、晒伤等目的而采取一些方法来阻隔或吸收紫外线。一般的防晒方法：涂抹防晒产品、使用防晒衣等物品、食用防晒食物等。防晒产品分为物理防晒、化学防晒、生物防晒；其中，防晒指数的高低能够反映防晒产品紫外线防护能力的大小。
马甲	马甲是干贝的别称，软体动物，肉柱称“江珧柱”，干制后又称“干贝”，是珍贵的海味品。亦称“玉珧”，出自《周愚卿江西美刘棠仲同赋江珧诗牵强奉答》。
棉袄	棉袄是一种在冬季穿用的具有很强保暖作用的上衣，这种服装一共有三层，最外一层叫面子，主要是用一些较厚的颜色鲜艳或有花纹的布料;中间一层是具有很强保暖作用的棉花;最里一层叫里子，一般是用比较轻薄的布料。还有一种棉袄是把面子和夹有棉花的保暖层分开制做的，这种棉袄就有了四层，穿的时候只要把保暖层套在里面就行了，它们用拉链或扣子相连接。
台式	百度百科是一部内容开放、自由的网络百科全书，旨在创造一个涵盖所有领域知识，服务所有互联网用户的中文知识性百科全书。在这里你可以参与词条编辑，分享贡献你的
床上用品	床上用品指摆放于床上，供人在睡眠时使用的物品，包括被褥、被套、床单、床罩、床笠、枕套、枕芯、毯子、凉席和蚊帐。床上用品是家纺的重要组成部分，按照中国家纺协会的分类有：1,套罩类，2 枕类，3 被褥类，4、套件。
游戏	游戏是所有哺乳类动物，特别是灵长类动物学习生存的第一步。它是一种基于物质需求满足之上的，在一些特定时间、空间范围内遵循某种特定规则的，追求精神世界需求满足的社会行为方式，但同时这种行为方式也是哺乳类动物或者灵长类动物所需的一种降压减排的方式，不管是在出生幼年期，或者发育期，成熟期都会需要的一种行为方式。合理适度的游戏允许人类在模拟环境下挑战和克服障碍，可以帮助人类开发智力、锻炼思维和反应能力、训练技能、培养规则意识等，大型网络游戏还可以培养战略战术意识和团队精神。但凡事过犹不及，过度游戏也会对人的身心健康产生危害，沉迷于虚拟世界里，随心所欲的宣泄情感，因此长期沉迷网络游戏的孩子会对周围的人和事冷漠麻木，有的还会荒废学业，甚至发生犯罪现象，给正常生长带来各种各样的危害。2018年6月18日，世界卫生组织发布新版《国际疾病分类》，“游戏障碍”，被列为疾病。但是游戏障碍与人们口中说的游戏成瘾是两
办公室	办公室读音bàngōngshì英文名Office： 处理一种特定事务的地方或提供服务的地方。是提供工作办公的场所，不同类型的企业，办公场所有所不同，由办公设备，办公人员及其它辅助设备组成，在办公室适合放些对人和工作氛围有帮助的东西，如花，画等。 办公室，还可以指一种机构，如区委办公室、区政府办公室、党校办公室等，它是一个单位对外的窗口，对内协助领导工作的机关。
包包	包包（英文：Bag），即手袋箱包，包括钱包、钥匙包、零钱包、手拿包、拎包、背包、书包、挎包、公文包等等。不仅用于存放个人用品，也能体现一个人的身份、地位、经济状况乃至性格等等。一个经过精心选择的皮包具有画龙点睛的作用，它能将你装饰成真正的女白领。
两用	两用，拼音lǐang yòng，是指并用；一起使用。
功夫	《功夫》是由周星驰执导，周星驰、曾谨昌、霍昕、陈文强编剧，周星驰、梁小龙、元华等主演的动作喜剧类电影，于2004年12月23日在中国上映。影片讲述了一个街头混混变成一代武术家，一个本性善良的黑帮流氓改邪归正的故事。
书包	书包，是指用布、皮革等制成的袋子。学生用来携带课本、文具用品。根据消费者品位的改变，书包发展出了一种更能减轻学生负担的书包——箱包。箱包的材质更加多样化。真皮、PU、涤纶、帆布、棉麻等质地箱包引领时尚潮流。同时，在越来越标榜个性的时代，简约、复古、卡通等各类风格也从不同侧面迎合时尚人士张扬个性的需求。
中老年	不同的文化圈对于老年有着不同的定义，由于生活质量的提高，生命周期变长，各年龄的分界线开始模糊，中老年一般是指人类生命历程中青年之后的阶段，包括中年和老年。世界卫生组织对老年人的定义为60周岁以上的人群为老年。老年这个概念在中国一般界定，一般指男人60岁之后，女人55岁之后直至生命结束的这一阶段。
床单	床单，读音为chuáng dān，是床上用的纺织品之一，也称被单、被罩。一般采用阔幅手感柔软保暖性好的织物。
带盖	百度百科是一部内容开放、自由的网络百科全书，旨在创造一个涵盖所有领域知识，服务所有互联网用户的中文知识性百科全书。在这里你可以参与词条编辑，分享贡献你的
巧克力	巧克力（chocolate也译朱古力），原产中南美洲，其鼻祖是“xocolatl”，意为“苦水”。其主要原料可可豆产于赤道南北纬18度以内的狭长地带。作饮料时，常称为“热巧克力”或可可亚。
音箱	音箱指可将音频信号变换为声音的一种设备。通俗的讲就是指音箱主机箱体或低音炮箱体内自带功率放大器，对音频信号进行放大处理后由音箱本身回放出声音，使其声音变大。音箱是整个音响系统的终端，其作用是把音频电能转换成相应的声能，并把它辐射到空间去。它是音响系统极其重要的组成部分，担负着把电信号转变成声信号供人的耳朵直接聆听的任务。
chic	Chic，拼音[英][ʃi:k][美][ʃik]，意思是adj.<法>漂亮的/n.高雅，雅致。
软底	也称为虚底或水底酱层厚。由于水底有一层较厚且松软的沉淀物质，形成软底。垂钩时，在正常找底之后，用比重稍大一点的或硬一些的钓饵再一次找底，以便确定水底是软底还是实底。比如说，用比重轻的饵调五钓五，换上比重大的饵，在原钓位不移动浮漂的前提下，浮漂没入水中，即说明此钓点为软底。遇到软底的情况，如果钓得钝一些，饵和钩子的重量再大一点，鱼饵可能会完全陷在软底的酱层中，鱼根本看不见饵。 
塑料	塑料是以单体为原料，通过加聚或缩聚反应聚合而成的高分子化合物(macromolecules)，其抗形变能力中等，介于纤维和橡胶之间，由合成树脂及填料、增塑剂、稳定剂、润滑剂、色料等添加剂组成。塑料的主要成分是树脂。树脂是指尚未和各种添加剂混合的高分子化合物。树脂这一名词最初是由动植物分泌出的脂质而得名，如松香、虫胶等。树脂约占塑料总重量的40%～100%。塑料的基本性能主要决定于树脂的本性，但添加剂也起着重要作用。有些塑料基本上是由合成树脂所组成，不含或少含添加剂，如有机玻璃、
迷彩	最早的军服没有统一的颜色要求，如西欧中世纪时期，出现了属于贵族的私人性质军队———骑士式骑兵。他们自备服装，没有统一的军服，服装的颜色也是多种多样，作战时，常常敌我难辨，往往误伤自己人，不利作战。到了15世纪，西欧出现了雇佣军，才出现了军服。路易十四时期，法国正式规定了统一的军服，而且不同兵种军服颜色不同：禁卫军穿白色军服，龙骑兵穿红色军服，步兵穿灰色军服。同时，各色军服上的佩饰艳丽，十分醒目。 作战服装用伪装迷彩，是隐蔽自己、消灭敌人的需要。这是在战争中不断总结经验而逐步发展起来的如狙击手所穿的吉利服。
滋润	1.湿润,不干燥。2. 用食物或营养品供应。3.浸润;使湿润。4.增加水分，使不干涸。5.来形容人的生活比较舒适。
烘焙	烘焙，又称为烘烤、焙烤，是指在物料燃点之下通过干热的方式使物料脱水变干变硬的过程。烘焙是面包、蛋糕类产品制作不可缺少的步骤，通过烘焙后淀粉产生糊化、蛋白质变性等一系列化学变化后，面包、蛋糕达到熟化的目的。也能使食物的口感发生变化。
改装	改装（gǎi zhuāng），词语，有改变设备原来的结构、装置；改变包装；改变装束等意思。
长裙	百度百科是一部内容开放、自由的网络百科全书，旨在创造一个涵盖所有领域知识，服务所有互联网用户的中文知识性百科全书。在这里你可以参与词条编辑，分享贡献你的
原味	原味是一种味道，指事物本来特有的味道没有经过人为添加的味道。多指食物原始的的味道。如，原味牛奶，原味瓜子，原味咖啡，原味薯片等……
糕点	糕点(Cakes and Pastries)是一种食品。它是以面粉或米粉、糖、油脂、蛋、乳品等为主要原料，配以各种辅料、馅料和调味料，初制成型，再经蒸、烤、炸、炒等方式加工制成。
桌面	桌面（Desktop），是指打开计算机并成功登录系统之后看到的显示器主屏幕区域，是计算机用语。桌面的定义广泛，它包括任务栏和Windows边栏及“开始”按钮 。边栏包含称为小工具的小程序，而“开始”按钮可以访问程序、文件夹和计算机设置。桌面文件一般存放在C盘，用户名下的“桌面”文件夹内。桌面也可以指传统意义上的书桌或者写字台表面。
办公	办公是一个汉语词汇，拼音是bàngōng，意思是处理公事，处理公务。语出《二十年目睹之怪现状》第十回：“他的意思，还以为那包探、巡捕是办公的人，一定公正的呢。” 
饼干	饼干的词源是“烤过两次的面包”，是从法语的bis（再来一次）和cuit（烤）中由来的。它是用面粉和水或牛奶不放酵母而烤出来的，可作为旅行、航海、登山时的储存食品，在战争时期用于军人们的备用食品也是非常方便适用的。初期饼干的产业是上述所说的长期的航海或战争中的紧急食品的概念，它开始是以HandMade-Type(手工形态)传播，产业革命以后因机械技术的发达，饼干的制作设备及技术迅速发展，扩散到全世界各地。饼干类包含饼干（Biscuit），曲奇饼干（Cookies），苏打饼干（Cracker）和披萨饼干（Pizza）等等。
童鞋	儿童穿的鞋子（儿童的年龄范围定义很广，一般在0-16岁之间）。童鞋是专门为这个年龄段的人而设计的，并依据这个年龄段的孩子脚的生长发育特点而设计适合他们穿着的鞋子，讲究轻巧、透气、舒适、适合脚型健康生长等特点。
小型	小型，详细解释指形状或规模小。
电动	百度百科是一部内容开放、自由的网络百科全书，旨在创造一个涵盖所有领域知识，服务所有互联网用户的中文知识性百科全书。在这里你可以参与词条编辑，分享贡献你的
灯具	灯具，是指能透光、分配和改变光源光分布的器具，包括除光源外所有用于固定和保护光源所需的全部零部件，以及与电源连接所必需的线路附件。
骑行	骑行是一种健康自然的运动旅游方式 ，能充分享受旅行过程之美 。一辆单车，一个背包即可出行 ，简单又环保。在不断而来的困难当中体验挑战，在旅途的终点体验成功。骑行可以改善记忆力。不论是对于记忆力较强还是较弱的人来说，骑自行车都具有提高记忆力的作用，缓解帕金森，骑车可以改善与运动有关的大脑区域的活动情况。骑行也可以防癌。日常缺乏运动，就是容易致癌的不良行为之一。长期坚持骑自行车可增强心血管功能，尤其是有氧运动，提高人体新陈代谢和免疫力，起到健身防癌的作用。
撞色	撞色是指对比色搭配，包括强烈色配合或者补色配合。强烈色配合指两个相隔较远的颜色相配，如：黄色与紫色，红色与青绿色，这种配色比较强烈；补色配合指两个相对的颜色的配合，如：红与绿，青与橙，黑与白等。撞色成了许多设计师表达"自信与活力，活出自己的个性，张扬自己的气魄"这一主题的不二选择。
衣柜	衣柜是收纳存放衣物的柜具，通常以不锈钢、实木、钢化玻璃、五金配件为材料，一般以柜体、门板、静音轮子、门帘为组件，内置挂衣杆、裤架、拉篮、消毒灯具等配件，采用冲孔、装配、压铆、焊接等工艺，具有阻燃、防鼠、无缝防蟑螂、防尘、防蛀、防潮、洁净美观、移动方便等作用，有大容量智能消毒衣柜、无电源通玻柜、不锈钢衣柜、紫外线消毒保洁衣柜、防潮多功能衣柜、男女更衣柜、干燥防蟑螂衣柜、折叠衣柜、简易衣柜。常见的分为平开门，柜内与柜外推拉门等，衣柜所用的板材一般有不锈钢、金属、木材等，是家庭常用的家具之一。一般衣柜柜体由18mm厚的材料来做（刨花板、密度板、实木板、复合多层板、指接板）；而门板（移门则由9mm的木质材料《UV板，双饰面板，波浪板，百叶板，彩绘板》或者5mm的玻璃移门；平开门一般用16mm或者18mm的材料来做）；一般情况五金对于衣柜生产厂家来说，是配套的，自己不生产。也有少数商家自己生产衣柜所
木质	木质部由导管、管胞、木纤维和木薄壁组织细胞以及木射线组成。木质部（xylem）维管植物（蕨类植物、裸子植物和被子植物）中，主要起输导水分和无机盐，并有支持植物体作用的复合组织。
礼服	在庄重的场合或举行仪式时穿的服装，如晚礼服。举行重要典礼时按规定所穿的衣服。礼服是以裙装为基本款式特征，是指在某些重大场合上参与者所穿着的庄重而且正式的服装。礼服有多种分类，西方传统的礼服包括晨礼服、小礼服（晚餐礼服或便礼服）和大礼服（燕尾服）。晚礼服并不包含在西方传统礼服之列。
diy	DIY是“Do It Yourself”的英文缩写，意思是自己动手制作。DIY最初兴起于电脑的拼装，并逐渐演绎成为一种流行生活方式。简单来说，DIY没有专业资质的限制，想做就做，每个都可以利用DIY做出一份私人订制表达自我的“产品”来。
礼品	礼品又称礼物。通常是人和人之间互相赠送的物件。其目的是为了取悦对方，或表达善意、敬意。礼物也用来庆祝节日或重要的日子，比如情人节的玫瑰或生日礼物，不可不送。礼物也可以是非物质的。中国古代有“千里送鹅毛，礼轻情义重”的说法，表示礼物的价值在于送礼者的善意和心意，而非礼物本身的价值。礼物不需要太贵，只要表达了心意就可以了。礼物拉近了人与人之间的距离。中央纪委国家监委网站的相关统计数据显示，“中秋国庆期间违反中央八项规定精神问题监督举报曝光专区”近三年中通报了989起案例。 其中，数量排名第二位的是违规收送礼品礼金，181起。
硅胶	硅胶别名：硅酸凝胶，是一种高活性吸附材料，属非晶态物质。硅胶主要成分是二氧化硅，化学性质稳定，不燃烧。
轻薄	轻薄，汉语词汇。主要有以下几个含义：1.轻佻浮薄。 2.指轻佻浮薄的人。 3.侮辱玩弄。 4.轻靡，浅薄。 5微薄，菲薄。 6.轻盈纤弱。 7.谓减少，减轻。 8.轻视鄙薄；不尊重。 9.卑贱；低微。
高清	高清，英文为“High Definition”，意思是“高分辨率”。一般所说的高清，有四个含义：高清电视，高清设备，高清格式，高清电影等。
挂件	不能单独成件，主要是和绳链配合使用。如材质虽多种多样，主要是玉石的，脱蜡琉璃挂件等。一般用来挂在手机，mp4等，起装饰作用。或挂在脖子、手腕上。
手绘	手绘是从事建筑、服饰陈列设计、橱窗设计、家居软装设计、空间花艺设计、美术、园林、环艺、摄影、工业设计、视觉传达等专业学习的学生一门重要的专业必修课程。手绘在效果图的学习过程中，临摹是一个非常重要的内容与环节。它是衡量大学生手绘能力的重要指标。同时对大学生毕业，就业都具有很大的影响。与其相对应的是电脑效果图。手绘与我们的现代生活密不可分，建筑、服装、插画、动漫……手绘的形式分门别类，各具专业性，对建筑师、研究学者、设计人员等设计绘图相关职业的人来说，手绘设计的学习是一个贯穿职业生涯的过程。手绘培训是一种以手绘技能需求为对象的教育训练，对现代社会设计美学的传承有着不可取代的现实意义。手绘是应用于各个行业手工绘制图案的技术手法，设计类手绘主要是前期构思设计方案的研究型手绘和设计成果部分的表现型手绘，前期部分被称为草图，成果部分被称为表现图或者效果图。手绘内容很广阔，所以言语无法尽善表达。“图画是
储物	百度百科是一部内容开放、自由的网络百科全书，旨在创造一个涵盖所有领域知识，服务所有互联网用户的中文知识性百科全书。在这里你可以参与词条编辑，分享贡献你的
韩式	百度百科是一部内容开放、自由的网络百科全书，旨在创造一个涵盖所有领域知识，服务所有互联网用户的中文知识性百科全书。在这里你可以参与词条编辑，分享贡献你的
正装	所谓正装，是指适用于严肃的场合的正式服装，正装就是正式场合的装束，而非娱乐和居家环境的装束。如西服、中山装、民族服饰等。
布艺沙发	布艺沙发主要是指主料是用布的沙发，经过艺术加工，达到一定的艺术效果，满足人们的生活需求 。该类沙发透气性良好，防敏感，容易清洗。布艺沙发的弹性材料质量影响着沙发的舒适和使用寿命。因此，弹性材料要耐压性强、弹性好、密度高，人们选购时除试坐感觉外，可向企业索取相关说明介绍，以确保产品质量。
散装	一种商品出售方式，指商品出售时由大包分成小包或不加包装，方便顾客。
美国	美利坚合众国（英语：United States of America），简称“美国”（United States），是由华盛顿哥伦比亚特区、50个州和关岛等众多海外领土组成的联邦共和立宪制国家。其主体部分位于北美洲中部，美国中央情报局《世界概况》1989年至1996年初始版美国总面积是937.3万平方公里，人口3.3亿，通用英语，是一个移民国家。美国原为印第安人的聚居地，15世纪末，西班牙、荷兰、法国、英国等相继移民至此。18世纪前，英国在美国大西洋沿岸建立了13个英属北美殖民地。1775年，爆发了美国人民反抗大英帝国
短裤	短裤(shorts)是遮盖下体至大腿的衣服，因比长裤短而得名，主要有内裤和外裤之分。古称褌，其中外裤有男装或女装之分，短裤长短不一，有热裤、三分裤、五分裤等。外短裤原为男童服装，后来在1970年代欧美因能源危机而提倡减少使用空调及风扇而改穿衣料较少的衣服，如今已成为女性的流行时装。
台灯	台灯（Desk lamp），是灯的一种，小巧精致，方便携带。台灯主要是装饰作用，便于阅读、学习、工作。台灯已经远远超越了台灯本身的价值，台灯已经变成了一个艺术品。
轻便	基本信息【词语】轻便【拼音】qīng biàn【解释】[light; portable] 轻松方便
食品	食品，指各种供人食用或者饮用的成品和原料以及按照传统既是食品又是中药材的物品，但是不包括以治疗为目的的物品。（2015年4月24日第十二届全国人民代表大会常务委员会第十四次会议修订《中华人民共和国食品安全法》“食品”的含义）1994年《食品工业基本术语》对食品的定义为：可供人类食用或饮用的物质，包括加工食品，半成品和未加工食品，不包括烟草或只作药品用的物质。从食品卫生立法和管理的角度，广义的食品概念还涉及到：所生产食品的原料，食品原料种植，养殖过程接触的物质和环境，食品的添加物质，所有直接或间接接触食品的包装材料，设施以及影响食品原有品质的环境。
男表	手表，又叫腕表。即佩戴在手腕上的用以计时的工具。男士手表 ，即专门提供给男士使用的手表。手表虽然只是个计时工具，但它是男人的饰品是时尚和声望的象征。在社交场合，佩戴手表，通常意味着时间观念强、作风严谨。这时年轻的男士可以偏向于时尚的表款、而中年或成熟的男士可以偏向于简约、经典的表款。
饰品	饰品是用来装饰的物品，一般用途为美化个人仪表，装点居室，美化公共环境，装点汽车。故饰品可分为以下几类：居家饰品、服饰饰品、汽车饰品等。随着佩戴饰品的人群逐渐增加，批发饰品这个行业在逐渐的兴起。
公仔	“公仔”即卡通玩偶。这个词源自上世纪70年代香港、澳门，是世界动漫产业兴盛发展的新词汇。公仔产品是源自美国、日本和韩国等的动画影视、漫画书刊、和网游的角色形象的衍生产品及原创卡通动物、卡通人物形象实物的产品；公仔不同于传统意义上的玩具概念，公仔更具有文化内涵，更富有故事情节，更富有个性和人格化的概念。因此公仔更受到成年人的宠爱和喜欢。
靠垫	靠垫是卧室内不可缺少的织物制品，它使用舒适并具有其它物品不可替代的装饰作用。用靠垫来调节人体与座位、床位的接触点以获得更舒适的角度来减轻疲劳。因靠垫使用方便、灵活，便于人们用于各种场合环境。尤为卧室的床上、沙发上被广泛采用。在地毯上，还可以利用靠垫来当做坐椅。靠垫的装饰作用较为突出，通过靠垫的色彩及质料与周围环境的对比，能使室内更加具有可观性。
男款	百度百科是一部内容开放、自由的网络百科全书，旨在创造一个涵盖所有领域知识，服务所有互联网用户的中文知识性百科全书。在这里你可以参与词条编辑，分享贡献你的
蛋糕	蛋糕是沙盒游戏《Minecraft》中能被玩家吃掉的食物方块。
床头	床头原意是指坐榻或床铺的旁边。
便携式	便携式是汉语词语，拼音为biàn xié shì，释义为便于携带的。
18	云雀恭弥，是日本著名动漫《家庭教师》中的人气角色。为主人公沢田纲吉的云之守护者。并盛中学的风纪委员长，喜欢学校，讨厌群聚、被束缚，是一个战斗狂热分子，对于与一切强者战斗都充满兴趣。虽然表面上声称不会和家族成员群聚，但家族处于危难的时候都会帮助他们，让扭转劣势，是家教中的重要人物。
超轻	百度百科是一部内容开放、自由的网络百科全书，旨在创造一个涵盖所有领域知识，服务所有互联网用户的中文知识性百科全书。在这里你可以参与词条编辑，分享贡献你的
辅食	辅食是完整营养均衡，对成长中的孩子是很重要的，特别是在0岁阶段的营养给予，更是奠定宝宝一生健康的根基。在婴儿阶段，母乳当然是宝宝最理想的食品，但随着宝宝一天天长大，满六个月开始，光吃母乳或者婴儿配方奶已经无法满足宝宝的营养需求。所以这段时间，除了原先母乳或婴儿配方奶之外，另外还应给予宝宝一些固体实物，这就是我们所说的辅食。辅食包括米粉、泥湖状食品以及其他的一些家制食品。
跑鞋	跑鞋又名运动鞋，根据生物力学的需要跑鞋可分为提供减震性、提供稳定性、提供运动控制三大类。提供减震性的跑鞋，通常有较柔软的夹层鞋底，辅助足部在运动时均匀受力，帮助足部减震。鞋体通常较轻，稳定性会相对较差。提供稳定性的跑鞋，鞋底通常具有受力均匀的柱子或内侧具有夹层结构。提供运动控制的跑鞋，通常比较坚硬，能减小或控制足部的过度内翻，防止脚踝受伤，这种跑鞋的重量通常要比其他跑鞋重。
凉鞋	凉鞋（Sandal）是一种脚趾外露的鞋类，以赤脚穿着为主，通风凉快似拖鞋，不过凉鞋比拖鞋底厚，有鞋尾，用料多一点。凉鞋可分多种类型：有平跟、坡跟、高跟等。传统认为，凉鞋跟拖鞋一样，出席庄重的场合、做跑步运动、及驾驶车辆，不适当穿着凉鞋。不过，夏天到沙滩散步，业余休闲生活等最适合穿凉鞋。因为有着极其简单的构造，凉鞋是人类历史上最早出现的足上用品，它是从原始的包裹物演变而来的。古代文明时期都曾经出现过凉鞋，而且它们的外观结构看起来是：在一副坚实的鞋底上绑系着带子或绳。
榻榻米	榻榻米为日语音译，日本名为叠敷。上古时期其生活方式称之为席居制、筵席制。榻榻米起源于中国，但起源时间无可考证。迹象表明 ，尧舜之后皆是以席居（榻榻米）为主要生活方式。两汉时期是席居（榻榻米）发展的巅峰。汉至唐400年间，凳子及高脚床盛行，席居逐渐在中国衰落。具体传入日韩等地的时期已不可考。随时代变迁，席居也由筵（竹制）上铺席变化成日本现今的榻榻米，由日本传承发展。西安皇室古墓里就有席居。榻榻米多为蔺草编织而成，一年四季都铺在地上供人坐或卧的一种家具。一般家庭的榻榻米大部分被设计在房间阳台、书房或者大厅的地面。
手提包	手提袋、礼品袋是日常生活中不可或缺的一个组成部分，往往能显示出一个人的品位。手提袋设计，愈来愈成为商家促进销售的广告载体，也是各个服装品牌打广告的手段之一。手提袋设计，至少要明确三点：第一，品牌的气质如何表现，简约时尚还是传统古典？第二，品牌LOGO如何体现，广告语、图案与字体设计整合；第三，手提袋的材料与规格、工艺等。
双人床	比最早的床大 可以容纳2个人甚至更多的人使用。通常长可达2-2.2米，宽可达1.5-1.8米。
奶瓶	奶瓶，是用来盛奶的一种器具，一般给婴儿使用。奶瓶本身不包含奶嘴，仅仅指瓶身，但是一般生产婴儿奶瓶的厂家都会随瓶赠送一只奶嘴。对于奶瓶中的婴儿奶瓶，在原料上来说，可以分为：玻璃奶瓶、塑料奶瓶和硅胶奶瓶。其中塑料奶瓶的材质一般有PC，PP,PES,PPSU、硅胶。除了PC其他都不含双酚A（BPA），而“PC“材质被证明遇100℃高温时会释放有毒物质双酚A,。
bf	游戏王卡组系列之一。动画以及漫画《游戏王5D'S》的主要角色克罗·霍根所使用，以同调召唤为主题的卡组系列。动画《游戏王ARC-V》的主要角色克罗·霍根使用的卡片详见「强袭黑羽」。日文名「BF（ブラックフェザー）」（Burakku Fezā），英文名作「BLACKWING」。除「黑羽-极光之奥罗拉」以及「黑羽驯鸟师-漆黑之鹰匠·乔」外，统一为暗属性·鸟兽族怪兽，其快速展开能力在同调召唤发展早期的同调主题卡组中拥有绝对优势。「黑羽」怪兽命名方式并非完全一致。动画的「黑羽」怪兽的名称大多数是由天气状况加上与风相关的名词；漫画的「黑羽」怪兽除「黑羽驯鸟师-漆黑之鹰匠·乔」以外，全部为夜晚的景象加上经典冷武器名称。
咖啡	咖啡是世界三大饮料之一，是用经过烘焙的咖啡豆制作出来的饮料，与可可、茶同为流行于世界的主要饮品。咖啡树是属茜草科常乔木，日常饮用的咖啡是用咖啡豆配合各种不同的烹煮器具制作出来的，而咖啡豆就是指咖啡树果实里面的果仁，再用适当的方法烘焙而成，一杯标准的咖啡品尝起来的味道不应该是苦涩的，一名合格的咖啡师在制作咖啡时会严谨地进行每一步操作，最后为客人呈上的咖啡在味觉上会呈现出不同程度的甜度、酸度、醇厚度或是干净度。
尖头	尖头，读音为jiān tóu，汉语词语，意思是指尖锐的端部。
红色	《红色》由杨磊执导，徐兵、孙强编剧，张鲁一、陶虹、周一围、李天柱等主演。该剧以淞沪会战后沦为孤岛的上海为背景，讲述了身怀绝技却隐居做小会计的徐天，因帮共产党运送物资和保护恋人田丹而身不由己卷入了腥风血雨的厮杀，最终与日本人展开生死对决的故事。该剧于2014年9月18日登陆山东卫视、北京卫视、重庆卫视、湖北卫视黄金档播出。
简易	一：简即简单，易即容易，综合为简易，也就是简单容易的缩写。这是人们公认的基本意义。例：简易操作法；简易楼。 二：有一定的难度。例：刚学些简易的东西。（意思是：好像费了不少劲。） 三：在学术方面，简易是一种自然规律。万事万物都自觉不自觉地按照简易的方式和方法去动作。 四：在生活工作当中，人们一行一动倾向于简易，甚至挖空心思地去考虑简易的办法。书面用语>（性情）平易；不拘礼节；例：为人简易
书桌	书桌，指供书写或阅读用的桌子，通常配有抽屉，分格和文件架。
usb	USB，是英文Universal Serial Bus（通用串行总线）的缩写，是一个外部总线标准，用于规范电脑与外部设备的连接和通讯。是应用在PC领域的接口技术。
保温	保温是一种科学、高效的节能技术措施，可以使热量的散发传导速度减慢。保温是指在供热管道及其附件表面敷设保温层，减少热媒在输送过程中的无效热损失，并使热媒维持一定的参数以满足用户需求。
生日礼物	生日礼物是指在他人的生日时，为了表达了人与人之间最温馨最美好的心意。最好的生日礼物不一定是最贵重的。生日礼物所传达的是对他人最诚挚的希冀与祝愿，可以增进情谊，传达爱意。对于生日礼物，很多人并不在乎其贵贱，看重的是礼物中所包含的情感价值。
13	13是12与14之间的自然数。13还是奇数、质数、两位数。在数学中和之前的素数11组成孪生素数。数字13在中国是一个吉祥、高贵的数字：佛教里的13是大吉数，佛教传入中国宗派为十三宗，代表功德圆满：如布达拉宫13层、天宁佛塔13层等；周易81数理灵意中，13亦是大吉大利之数：13（春阳牡丹）：智能超群的成功数（大吉）；从中国的历史文化来看，13亦是受欢迎之数：佛教共有13经、13妹、13姨、13太保、13香、13行、少林13棍、兵法13章等；首届世界佛教论坛13日杭州开幕；撒切尔夫人的“幸运13”及近期上映的《13罗汉》等亦表明了国外友人偏爱数字13的潮流。13乃帝王之数，是皇帝的独享，皇帝腰带的玉枚制式的，十三枚，13是中国的数字帝王，象征的是一种权利，一种帝王的权利。
音响	音响特指电器设备组合发出声音的一套音频系统音响系统大体包含：1、声源设备：（列如：DVD、CD、MP3、MP4、电脑、手机、麦克风等声源输出设备）2、音频信号动态处理设备（压限器、效果器、调音台、音频处理器、均衡器等音频信号处理设备）3、音频信号放大设备（前级功率放大器、后级功率放大器、数字功率放大器等模拟功率放大器、设备）4、声音还原设备（全频音箱、吸顶喇叭、音柱、线阵音箱、阵列式音箱、高音喇叭、低音炮等等）。技术的的发展历史可以分为电子管、晶体管、集成电路、场效应管四个阶段。
一体	一体：词语一体：周笔畅演唱歌曲
青少年	青少年是青春期的年龄。青春期是儿童转变成人角色的过渡时期，青少年一般是指自上初中到高中毕业，初中阶段：13-15岁、高中阶段：16到成年，要经历6年时间的中学阶段。古时指年轻的男女、今指青年和少年。学者们认为很难给青春期下一个准确的定义，因为它可以从不同角度来理解。 在当今社会，对青春期的一个全面的理解来源于各个角度的信息，最重要的包括信息来自于心理学，生理学，历史，社会学，教育学以及人类学。 从所有的这些观点和角度来看，我们可以解释青春期是一段改变、转化的时期。它的目的是让孩子能够为自己成人角色的转换做准备。
小孩	曾卓君，1989年4月26日出生于广东省广州市，绰号“小孩”，中国著名格斗游戏玩家，主打拳皇和街霸系列。曾夺日本斗剧07 拳皇98项目冠军、美国EVO2014 拳皇13项目冠军、加拿大杯2013 超级街霸4AE2012项目冠军、澳洲Shadowloo Showdown2012 拳皇13项目冠军、EVO2016 拳皇14冠军、美国ESL2016 街霸5项目冠军、美国SCR2016 拳皇14项目和街头霸王5项目冠军、日本TOPANGA 超级街霸4AE2012世界联赛亚军、美国EVO2012 超级街霸4AE2012项目四强等国际赛事奖项，同时在全国比赛中也多次问鼎桂冠。小孩还是著名的KOF随机选手，对众多游戏角色的研究皆有深厚的造诣，人称“东升机神”、“问号之王”。曾卓君6岁接触街机格斗游戏，12岁的时候就夺得了广州首届拳皇2000比赛冠军，而在之后几年里，逐渐参与国内外各大格斗游戏赛事。201
书架	书架（Bookshelf），是人们用来专门放书的器具。由于书架形态、结构的不同，又有书柜、书橱、书隔等其他名称。书架是我们生活中的普遍用具。
篮球鞋	篮球鞋即SNEAKER，同时也将球鞋爱好者融入到SNEAKER一词中，使得SNEAKER有更宽泛的定义。 篮球是一项剧烈运动，为了能应付激烈的运动，对于一双篮球鞋来讲，就需要有很好的耐久性，支撑性、稳定性，舒适性和良好的减震作用。篮球运动中不断的起动、急停、起跳和迅速的左右移动等动作使得你在挑选篮球鞋时必须把鞋的特性放在绝对首位。另外，你个人的打球风格也是一个很重要的因素，可以根据这个选择自己所需的不同类型的篮球鞋。
床垫	床垫是为了保证消费者获得健康而又舒适的睡眠而使用的一种介于人体和床之间的物品，床垫材质繁多，不同材料制作的床垫能给人带来不同的睡眠效果。
高档	【词目】高档【拼音】gāo dàng【英译】[high；top grade;superior quality]【基本解释】质量好，价钱贵。
新鲜	新鲜是一个汉语词语，读音为xīn xiān，意思是刚生产、刚收集或刚制成的。形容物品生产日期很近，没有遭受过多的污染。出自《文子·上仁》。
橡木	原木（Wood）(之前被称为原木(Log))是一种在Minecraft 0.0.14a版本中第一次出现的方块。它们在游戏中是一种非常基础的方块，可以用于合成各种其他方块和工具。
结婚	结婚（jié hūn）， 法律上称为婚姻成立。是指配偶双方依照法律规定的条件和程序确立配偶关系的民事法律行为，并承担由此而产生的权利、义务及其他责任。
无袖	无袖衫（sleeveless），没有袖子从肩峰处露出整个手臂的服装。无袖衫一般为女性穿，男子的无袖衫一般直接称为背心。为了撑起无袖衫，该服装适合较为丰满女性穿着，可充分展示女性上臂曲线美。
加肥	百度百科是一部内容开放、自由的网络百科全书，旨在创造一个涵盖所有领域知识，服务所有互联网用户的中文知识性百科全书。在这里你可以参与词条编辑，分享贡献你的
茶叶	指茶树的叶子和芽。别名茶、槚（jiǎ），茗，荈（chuǎn）。泛指可用于泡茶的常绿灌木茶树的叶子，以及用这些叶子泡制的饮料，后来引申为所有用植物花、叶、种子、根泡制的草本茶，如“菊花茶”等；用各种药材泡制的“凉茶”等，在中国文学中亦称雷芽。有些国家亦有以水果及香草等其它植物叶而泡出的茶，如“水果茶”。茶叶源于中国，茶叶最早是被作为祭品使用的。但从春秋后期就被人们作为菜食，在西汉中期发展为药用，西汉后期才发展为宫廷高级饮料，普及民间作为普通饮料那是西晋以后的事。发现最早人工种植茶叶的遗迹在浙江余姚的田螺山遗址，已有6000多年的历史。饮茶始于中国。叶革质，长圆形或椭圆形，可以用开水直接泡饮，依据品种和制作方式以及产品外形分成六大类。依据季节采制可分为春茶、夏茶、秋茶、冬茶。以各种毛茶或精制茶叶再加工形成再加茶，包括分为花茶、紧压茶、萃取茶、药用保健茶、茶食品、含茶饮料等。茶叶中含有儿茶素、胆
100	100（一百）是99与101之间的自然数。是3位数中最小的合数、自然数、偶数、平方数。最小的三位整数。是一个阿拉伯数字，是一个偶数。是第一个整百数。在玄幻风水中被称为圆满的数字。
铁艺	铁艺，称为铁艺术，有着悠久的历史，传统的铁艺主要运用于建筑、家居、园林的装饰。最早的铁制品产生于公元前2500年左右，小亚细亚的赫梯（Hittite）王国应当是铁艺的发源地。
镂空	镂空是一种雕刻技术。外面看起来是完整的图案，但里面是空的或者里面又镶嵌小的镂空物件。在当代，镂空一词在被更加广泛的运用。时尚界用此表现针织或裁剪技术，镂空时装是通透、性感的代名词。多家国际名牌都有自己经典的镂空款式，深受时尚人士喜爱。
耐磨	耐磨材料是一大类具有特殊电、磁、光、声、热、力、化学以及生物功能的新型材料，是信息技术、生物技术、能源技术等高技术领域和国防建设的重要基础材料，同时也对改造某些传统产业，如农业、化工、建材等起着重要作用。
餐椅	桌椅是指专供就餐用的椅子，是餐厅家具的一种。按餐椅材质分为：实木椅、钢木椅、曲木椅、铝合金椅、金属椅、藤椅、塑料椅、玻璃钢椅、亚克力椅、板式椅、杂木椅、宝宝餐椅和圈椅等。按餐椅用途分为：中餐椅,西餐椅,咖啡椅,快餐椅,酒吧椅,办公椅等。
中年	中年，是年龄段。读作： zhōng nián，介于“青年”和“老年”之间的年龄，没有明确的年龄划分，一般是指45至64岁的年龄。
底裤	底裤，意思是内裤，是一种方言。
咖啡杯	咖啡杯由负离子粉、电气石、优质粘土和其它基础材料烧结而成。 高咖啡杯放出的高浓度负离子可以对水发生电解作用，产生带有负电的氢氧基离子，使水中的大分子团变小，增强了水的溶解力和渗透力。因而咖啡杯内装的饮用水对饮料有更强的溶解能力，饮料效果更佳。
乡村	乡村是指乡村地区人类各种形式的居住场所（即村落或乡村聚落），乡村一般风景宜人，空气清新，较适合人群居住，民风淳朴。
呢子大衣	百度百科是一部内容开放、自由的网络百科全书，旨在创造一个涵盖所有领域知识，服务所有互联网用户的中文知识性百科全书。在这里你可以参与词条编辑，分享贡献你的
鞋柜	鞋柜的主要用途是来陈列闲置的鞋。随着社会的进步和人类生活水平的提高，从早期的木鞋柜演变成现在多种多样款式和制材的鞋柜，包括： 木质鞋柜、电子鞋柜、消毒鞋柜等等，功能和款式各不相同。传统鞋柜就是现在家居最为常用的鞋柜，主要就是为了实现鞋子的储藏功能、同时在款式上的不断变化和创新，使其能够和不同的家居环境像配合鞋柜，起到储藏鞋子和装饰的双向作用。
头层	百度百科是一部内容开放、自由的网络百科全书，旨在创造一个涵盖所有领域知识，服务所有互联网用户的中文知识性百科全书。在这里你可以参与词条编辑，分享贡献你的
紧身	紧身（jinshen）英文翻译为close,解释为贴身的意思。
吊带	吊带，是夏季衫唱主角的季节，有着流畅线条，轻柔质地，和充满淑女细节的吊带衫，无论是和男朋友约会还是和朋友去泡吧，穿上这样的吊带衫，性感而不失时髦品味。这一季的吊带展现了更多的时尚元素，千万别小看这样一件小小的单薄的吊带衫，仔细端详，其中千变万化的风景实在令人眼花缭乱。
速干	百度百科是一部内容开放、自由的网络百科全书，旨在创造一个涵盖所有领域知识，服务所有互联网用户的中文知识性百科全书。在这里你可以参与词条编辑，分享贡献你的
厚底	汽车在制造过程中一般会在车底、轮罩、挡泥板等部位电泳漆表面喷涂一定厚度的抗石击底涂胶，经面漆烘烤固化后，达到产品的性能要求，提高车身底盘的耐磨性及抗石击性能，降低汽车运行过程中产生的振动和噪声，延长汽车的使用寿命。
圆形	在一个平面内，一动点以一定点为中心，以一定长度为距离旋转一周所形成的封闭曲线叫做圆。圆有无数个对称轴。在同一平面内，到定点的距离等于定长的点的集合叫做圆。圆可以表示为集合{M||MO|=r},圆的标准方程是(x - a) ² + (y - b) ² = r ²。其中，o是圆心，r 是半径。圆形是一种圆锥曲线，由平行于圆锥底面的平面截圆锥得到。圆是一种几何图形。根据定义，通常用圆规来画圆。 同圆内圆的直径、半径长度永远相同，圆有无数条半径和无数条直径。圆是轴对称、中心对称图形。对称轴是直径所在的直线。 同时，圆又是“正无限多边形”，而“无限”只是一个概念。当多边形的边数越多时，其形状、周长、面积就都越接近于圆。所以，世界上没有真正的圆，圆实际上只是概念性的图形。
配件	配件，指装配机械的零件或部件；也指损坏后重新安装上的零件或部件。配件可以分为标准配件和可选配件两类。
糖果	糖果是糖果糕点的一种，指以糖类为主要成份的一种小吃。若水果或坚果类食物裹上糖衣，则称为甜食（如糖葫芦）。在亚洲文化广义上，巧克力及口香糖很多时亦会视为糖果的一种。在欧美国家，糖果是仅指指使用白砂糖或麦芽糖下去制作的产品。而古时欧美甚至使用蜂蜜为原料制作糖果，但因为蜂蜜成分过多不容易控制而不适用工业化生产。
外穿	百度百科是一部内容开放、自由的网络百科全书，旨在创造一个涵盖所有领域知识，服务所有互联网用户的中文知识性百科全书。在这里你可以参与词条编辑，分享贡献你的
支架	“支架”一词是从英文“Scaffold”翻译过来的，也译为“脚手架”，本来是建筑行业的一个术语，具体指建筑楼房时搭起的暂时性支持，这种支持会随着楼房的建成而被撤掉。但如今支架的应用极其广泛，工作生活中随处可以遇见，如照相机的三脚架，医学领域用到的心脏支架等。
立体	利用特种光学材料（通称光栅材料）在平面上展示出栩栩如生的立体世界，匪夷所思的立体效果。打破了传统平面图像的一成不变，为人们带来了新的视觉感受，使人过目难忘。手摸上去是平的，眼看上去是立体的，有突出的前景和深邃的后景，景物逼真。各类型图像都可以做出立体效果。
破洞	百度百科是一部内容开放、自由的网络百科全书，旨在创造一个涵盖所有领域知识，服务所有互联网用户的中文知识性百科全书。在这里你可以参与词条编辑，分享贡献你的
电磁炉	电磁炉又称为电磁灶，1957年第一台家用电磁炉诞生于德国。1972年，美国开始生产电磁炉，20世纪80年代初电磁炉在欧美及日本开始热销。电磁炉的原理是电磁感应现象，即利用交变电流通过线圈产生方向不断改变的交变磁场，处于交变磁场中的导体的内部将会出现涡旋电流（原因可参考法拉第电磁感应定律），这是涡旋电场推动导体中载流子（锅里的是电子而绝非铁原子）运动所致；涡旋电流的焦耳热效应使导体升温，从而实现加热。
清仓	清仓有三种意义：一、原义：清理（查察）仓库；二、引申义：全部售出。清仓这个词运用范围较多，如超市“清仓”、股票“清仓”等。
加大	百度百科是一部内容开放、自由的网络百科全书，旨在创造一个涵盖所有领域知识，服务所有互联网用户的中文知识性百科全书。在这里你可以参与词条编辑，分享贡献你的
幼儿园	幼儿园，原称勘儿园，是几百年前从普鲁士引进的体制。旧称蒙养园、幼稚园，为一种学前教育机构，用于对幼儿集中进行保育和教育，通常接纳三至六周岁的幼儿。幼儿园的任务为解除家庭在培养儿童时所受时间、空间、环境的制约，让幼儿身体、智力和心情得以健康发展。可以说幼儿园是小朋友的快乐天地，可以帮助孩子健康快乐地度过童年时光，不仅学到知识，而且可以从小接触集体生活。幼儿园教育作为整个教育体系基础的基础，是对儿童进行预备教育（性格完整健康、行为习惯良好、初步的自然与社会常识）。其教育课程没有明显的区分，大概由语言、科学、艺术、健康和社会等五个领域以及各种活动构成。各个领域相互融合，决定教学内容。
3d	3D是英文“3 Dimensions”的简称，中文是指三维、三个维度、三个坐标，即有长、宽、高。换句话说，就是立体的，3D就是空间的概念也就是由X、Y、Z三个轴组成的空间，是相对于只有长和宽的平面（2D）而言。根据科学猜想，人们本来就生活在四维的立体空间中（加一个时间维），眼睛和身体感知到的这个世界都是三维立体的（时间是虚构的），并且具有丰富的色彩、光泽、表面、材质等等外观质感，以及巧妙而错综复杂的内部结构和时空动态的运动关系；我们对这世界的任何发现和创造的原始冲动都是三维的。今天的3D，主要特指是基于电脑、互联网的数字化的3D/三维/立体技术，既可以是动词、是名词，又可以是形容词、是状态副词，也就是三维数字化。包括
蝴蝶结	蝴蝶结形状像蝴蝶的结子，又可以称同心结，外形酷似蝴蝶，制作材质也是不尽相同，形状大小不一，但外形美观大方，其打法有很多种，体现了我国古代的文化信仰及浓郁的宗教色彩，体现着人们追求真、善、美的良好的愿望。在佩玉上装饰一个“如意结”，引申为称心如意，万事如意。在扇子上装饰一 个“吉祥结”，代表大吉大利，吉人天相，祥瑞、美好。 在剑柄上装饰一个“法轮结”，有如轮黑心行，弃恶扬善之意。
坐垫	坐垫使用舒适并具有装饰作用形状多为方形、圆形和椭圆形。材料棉布、绒布、锦缎、尼龙或麻布最舒适材料质是记忆棉材质。
坚果	坚果，是闭果的一个分类，果皮坚硬，内含1粒或者多粒种子。如板栗，杏仁等的果实。坚果是植物的精华部分，一般都营养丰富，含蛋白质、油脂、矿物质、维生素较高，对人体生长发育、增强体质、预防疾病有极好的功效。根据权威机构研究得出：每周食用两次以上坚果能够降低人们患致命心脏病的风险，这是美国医生健康研究项目的两万名男性医生消费坚果的特点进行调查后的准确结果。
牛奶	牛奶是最古老的天然饮料之一，被誉为白色血液。牛奶中含有丰富的蛋白质、脂肪、维生素和矿物质等营养物质。乳蛋白中含有人体所必须的氨基酸；乳脂肪多为短链和中链脂肪酸，极易被人体吸收；钾、磷、钙等矿物质配比合理，易于人体吸收。
连体	1.形体相连2.形容关系极为密切。
少女	《京城学校：消失的少女们》是由李海英执导，朴宝英、严智媛主演的惊悚悬疑电影。该片讲述了1938年在朝鲜京城的寄宿女校，转学而来的学生追查同学一个个神秘消失真相的恐怖故事，于2015年6月18日在韩国上映。2015年11月20日，该片获得第52届韩国电影大钟奖最佳灯光奖。2015年11月26日，该片获得第36届韩国青龙电影奖人气奖。
小白鞋	百度百科是一部内容开放、自由的网络百科全书，旨在创造一个涵盖所有领域知识，服务所有互联网用户的中文知识性百科全书。在这里你可以参与词条编辑，分享贡献你的
面包	面包也写作麺包，一种用五谷（一般是麦类）磨粉制作并加热而制成的食品。以小麦粉为主要原料，以酵母、鸡蛋、油脂、糖、盐等为辅料，加水调制成面团，经过分割、成形、醒发、焙烤、冷却等过程加工而成的焙烤食品。
羊绒	羊绒（Cashmere）是生长在山羊外表皮层，掩在山羊粗毛根部的一层薄薄的细绒，日照时间减少（秋分）时长出，抵御风寒，日照时间增加（春分）后脱落，根据光照时间的长短，自然适应气候，属于稀有的特种动物纤维。羊绒之所以十分珍贵，不仅由于产量稀少（仅占世界动物纤维总产量的0.2%），更重要的是其优良的品质和特性，交易中以克论价，被人们认为是“纤维宝石”、“纤维皇后”。是目前人类能够利用的所有纺织原料都无法比拟的，因而又被称为“软黄金”。世界上约70%的羊绒产自中国，其质量上也优于其它国家。
绣花	据《尚书》载，远在4000多年前的章服制度，就规定“衣画而裳绣”。至周代，有“绣缋共职”的记载。湖北和湖南出土的战国、两汉的绣品，水平都很高。唐宋绣花施针匀细，设色丰富，盛行用绣花作书画，饰件等。明清时封建王朝的宫廷绣工规模很大，民间绣花也得到进一步发展，先后产了苏绣、粤绣、湘绣、蜀绣，号称“四大名绣”。此外尚有顾绣，京绣、瓯绣、鲁绣、闽绣、汴绣、汉绣和苗绣等，都各具风格，沿传迄今，历久不衰。
韩版百	百度百科是一部内容开放、自由的网络百科全书，旨在创造一个涵盖所有领域知识，服务所有互联网用户的中文知识性百科全书。在这里你可以参与词条编辑，分享贡献你的
半袖	半袖是一个汉语词汇，意思是半截袖衣裳。短袖衣。
聚拢	聚拢是中国汉语里的词汇，意思是会聚合拢起来。
书房	书房，又称家庭工作室，是作为阅读、书写以及业余学习、研究、工作的空间。特别是从事文教、科技、艺术工作者必备的活动空间。书房，是人们结束一天工作之后再次回到办公环境的一个场所。因此，它既是办公室的延伸，又是家庭生活的一部分。书房的双重性使其在家庭环境中处于一种独特的地位。
洋气	洋气，作形容词时指富有西洋的风格，也有指西方的文化，指富有现代化潮流的气息。现多用作中性词和褒义词。洋气，旧社会含有贬义，形容同胞崇洋媚外，现代一般形容穿戴的时髦。
枕头	枕头，是一种睡眠工具。一般认为，枕头是人们为睡眠舒适而采用的填充物。从现代医学研究上认识，人体的脊柱，从正面看是一条直线，但侧面看是具有四个生理弯曲的曲线。为保护颈部的正常生理弯曲，维持人们睡眠时正常的生理活动，睡觉时须采用枕头。枕头一般由枕芯、枕套两部分构成。
粉色	粉色，通常指粉红色。这种颜色用途很广泛。如衣服、被套、毛巾、枕头、书包花朵、等，都有许多带有粉色；自然中多种花朵呈现粉色。生活中粉色还代表可爱，温馨，娇嫩、青春、明快、恋爱、萌等意义。
收腰	百度百科是一部内容开放、自由的网络百科全书，旨在创造一个涵盖所有领域知识，服务所有互联网用户的中文知识性百科全书。在这里你可以参与词条编辑，分享贡献你的
长方形	长方形，数学术语，是有一个角是直角的平行四边形叫做长方形。也定义为四个角都是直角的平行四边形，同时，正方形既是长方形，也是菱形。长方形的性质为：两条对角线相等；两条对角线互相平分；两组对边分别平行；两组对边分别相等；四个角都是直角；有2条对称轴（正方形有4条）；具有不稳定性（易变形）；长方形对角线长的平方为两边长平方的和；顺次连接矩形各边中点得到的四边形是菱形。
训练	训练是一个汉语词汇，读音为xùn liàn，指有计划有步骤地通过学习和辅导掌握某种技能。有意识地使受训者发生生理反应，从而改变受训者素质、能力的活动。和教育一样，训练也是培养人的一种手段。
自动	自动：汉语副词、形容词自动：Red Velvet迷你一辑《Ice Cream Cake》双主打之一
工装裤	工装裤（cargo pants）是一种宽松且有很多口袋的裤子。曾经是一百多年前的流行物，随着时间的推移，在各个行业和领域中都有着大量的粉丝，但是在上个世纪80年代后，它渐渐淡出了人们的视线。随着现在经济危机的爆发，褪色多年的工装裤又随之袭来，在欧美时尚界掀起了不小的波澜，并且已经渗透到了中国，成为了流行时尚界的新宠儿。
酒柜	酒柜指储存酒的冷柜。按制冷方式可分为：电子半导体，压缩机直冷式，变频风冷式，按材质：有实木酒柜同合成酒柜，合成酒柜采用电子，木板，PVC等材质组合的酒柜，目前市应用最多的是合成酒柜系列，该系列柜从国外引进，现国内已大量生产及为国外客户OEM。
字母	原始人发展出的图示和表意符号是如今现代字母的原型，比如楔形文字和象形文字。最早的字母，是东闪米特人（现代分类称之为闪米特北支）使用的一种早期的象形文字的组合，大约出现在公元前1700至1500年间。公元前1000年又有其它四种字母，由东闪米特人的字母发展而来，西闪米特人南支（现代分类称之为闪米特南支）所使用的字母、迦南字母、阿拉姆字母和希腊字母。而罗马字母，大约在公元前500年从希腊字母中衍生出来，截止到2015年，所有的西欧语言（包括爱尔兰语，荷兰语，法语，德语等语言）都使用这种字母。
家居服	家居服：指在家中休息或操持家务会客等，穿着的一种服装。特点：是面料舒适，款式繁多，行动方便。随着生活水平的不断提高，人们现在慢慢把目光聚焦在如何更好的享受生活，家居服体现的是讲究的生活态度。家居服是由睡衣演变而来的，却是青出于蓝而胜于蓝。现在的家居服早已摆脱了纯粹睡衣的概念，涵盖的范围更广。从16世纪欧洲人穿上睡袍以来，睡衣随着时代变化也不停的改变着形象。到了上个世纪，社会气氛变得宽松和活跃，卧室着装也向着新的款式发展，发生根本性的变化。
手提	百度百科是一部内容开放、自由的网络百科全书，旨在创造一个涵盖所有领域知识，服务所有互联网用户的中文知识性百科全书。在这里你可以参与词条编辑，分享贡献你的
潮鞋	百度百科是一部内容开放、自由的网络百科全书，旨在创造一个涵盖所有领域知识，服务所有互联网用户的中文知识性百科全书。在这里你可以参与词条编辑，分享贡献你的
小学生	小学生，指正在小学上学的学生1、旧指在国子监童科和民间蒙馆、私塾读书的学生，今指在小学读书的学生。《文献通考·选举八》：“ 徽宗政和四年，小学生近千人，尚有继至者，分十斋处之。增教谕俸，不许受束脩。自八岁至十二岁，率以诵经书字多少差次补内舍上舍。2、比喻对某方面要从头学起的人。多用作自谦之词。毛泽东的《序言和跋》：“和全党同志共同一起向群众学习，继续当一个小学生，这就是我的志愿。”
女款	百度百科是一部内容开放、自由的网络百科全书，旨在创造一个涵盖所有领域知识，服务所有互联网用户的中文知识性百科全书。在这里你可以参与词条编辑，分享贡献你的
钱包	钱包分为传统的实体物品装钱的包包和虚拟的电子钱包。
专柜	[bar] 商店内以一项或几项独特商品为特色的柜台或售货部。
保护套	对于保护套很多人的第一印象就是孩童时候的书套，这是最早、最普遍的一种保护套。人们通常所指的就是手机保护套，平板电脑保护套，或者其他一些精密、高端电子仪器产品的安全套。
瑜伽	瑜伽（英文：Yoga，印地语：योग）是一个汉语词汇，最早是从印度梵语“yug”或“yuj”而来，其含意为“一致”、“结合”或“和谐”。瑜伽源于古印度，是古印度六大哲学派别中的一系，探寻“梵我合一”的道理与方法。而现代人所称的瑜伽则主要是一系列的修身养心方法。大约在公元前300年，印度的大圣哲瑜伽之祖帕坦伽利（英文：Patanjali，印地语：पतंजलि）创作了《瑜伽经》，印度瑜伽在其基础上才真正成形，瑜伽行法被正式订为完整的八支体系。瑜伽是一个通过提升意识，帮助人类充分发挥潜能的体系。瑜伽姿势运用古老而易于掌握的技巧，改善人们生理、心理、情感和精神方面的能力，是一种达到身体、心灵与精神和谐统一的运动方式，包括调身的体位法、调息的呼吸法、调心的冥想法等，以达至身心的合一。瑜伽是一项有着5000年历史的关于身体、心理以及精神的练习，起源于印度，其目的是改善您的身体和心性。2014年12月1
男潮	百度百科是一部内容开放、自由的网络百科全书，旨在创造一个涵盖所有领域知识，服务所有互联网用户的中文知识性百科全书。在这里你可以参与词条编辑，分享贡献你的
磨砂	我们一般说的磨砂就是将原本表面光滑的物体变得不光滑，使光照射在表面形成漫反射状的一道工序。比如，磨砂玻璃使之变得不透明，磨砂皮衣，使之跟一般的皮革相比表面没那么亮。
呢子	呢子，一种较厚较密的毛织品，多用来做制服、大衣等。呢子面料由于风格新颖别致，挺括中不失柔软，朴实中又不失时尚，粗犷中蕴涵典雅，故在秋冬市场十分走俏。在新世界国际经营呢子面料的街道上，混纺色织、彩色高花、人字呢、格子呢、高花呢、燕子格等面料纷纷进入商场，让商家看到了秋冬市场的好前景。
毛绒	《毛绒》是由凯瑟琳·哈德威克执导，艾米莉·布朗宁和凯姆·吉甘戴出演的剧情片，于2013年上映。该片讲述了“毛绒乐队”的主唱迎来第二春的故事。
冲锋衣	冲锋衣，外文名Jackets，又名Outdoor Jackets，音译为夹克，户外运动必备装备之一。冲锋衣之所以能成为所有户外爱好者的首选外衣，是由其全天候的功能决定的。冲锋衣的 英语为“Jackets”或者“Outdoor Jackets”，音译过来就是“夹克”，冲锋衣并不神秘，就是夹克衫，但由于这种功能性服饰从国外传到中国时，国人为了和普通衣服区别开来，就从其“意译”上入手，叫做“冲锋衣”。因为冲锋衣最早用于在登高海拔雪山时，当离顶峰还有2-3小时路程时的最后冲锋，这时会脱去羽绒服，卸下大背包，只穿一件冲锋衣轻装前进，这就是中文名字的由来。
水晶	水晶（rock crystal）是稀有矿物，宝石的一种，石英结晶体，在矿物学上属于石英族。主要化学成份是二氧化硅，化学式为SiO2。纯净时形成无色透明的晶体。当含微量元素Al、Fe等时呈粉色、紫色、黄色，茶色等。经辐照微量元素形成不同类型的色心，产生不同的颜色，如紫色、黄色、茶色，粉色等。含伴生包裹体矿物的被称之为包裹体水晶，如发晶、绿幽灵、红兔毛等，内包物为金红石、电气石、阳起石、云母，绿泥石等。
内胆	百度百科是一部内容开放、自由的网络百科全书，旨在创造一个涵盖所有领域知识，服务所有互联网用户的中文知识性百科全书。在这里你可以参与词条编辑，分享贡献你的
早教	广义指从人出生到小学以前阶段的教育，狭义主要指上述阶段的早期学习。一些国家出现提前开始学习幼儿早教读、写、算，提前开始正式教育的探讨和实验。但另有人主张早期教育应重在发展智力。还有人认为早期教育应向前延伸到出生以前的母亲怀孕期的胎教。家庭教育对早期教育有重大影响。其中“体能、智能、心理能力三维平衡发展”理论最为科学，依据五万份孩子成长基准数据，提炼出孩子的九大成长目标：安全感、意志力、目标感、注意力、记忆力、思维能力、平衡、力量、速度。
帽子	帽子，一种戴在头部的服饰，多数可以覆盖头的整个顶部。帽子主要用于保护头部，部分帽子会有突出的边缘，可以遮盖阳光。帽子有遮阳、装饰、增温和防护等作用，因此种类也很多，选择也有很多讲究。帽子亦可作打扮之用，首先要根据脸型选择合适的帽子。其次要根据自己的身材来选择帽子。戴帽子和穿衣服一样，要尽量扬长避短。帽子的形式和颜色等必须和服饰等相配套。帽子也可以用来保护发型、遮盖秃头，或者是作为制服或宗教服饰的一部 分。可不同种类，例如高帽、太阳帽等等。有些帽子会有一块向外伸延的檐蓬，称为帽舌。戴帽子在不同的文化有不同的礼仪。这在西洋文化之中尤其重要，因为戴帽子在过去是社会身份的象征。
内裤	内裤（knicker），一般指贴身的下身内衣，分男装与女装两种。而且根据性别不同，款式也越来越多花样了。穿内裤各国各地出现的时间不一。内裤并不是古已有之的，汉代以前，女人下体无衣，到了汉朝才穿上开裆裤。直至现代，内裤款式和面料上已经有很多种了。
清洁	《清洁》是由奥利维耶·阿萨亚斯执导，张曼玉、尼克·诺尔蒂主演的剧情片，于2004年9月1日在法国上映。影片讲述了一位女乐手在丈夫吸毒去世后，努力摆脱毒品对自己生命的控制，最终重获清洁的故事。2004年，张曼玉凭借该片获得第57届戛纳国际电影节最佳女演员奖。
皮草	皮草是指利用动物的皮毛所制成的服装，具有保暖的作用，现在的皮草都较为美观并且价格较高也是不少消费者的消费对象。狐狸、貂、貉子、獭兔和牛羊等毛皮兽动物，都是皮草原料的主要来源。我们有称做“毛皮”的、有叫“裘皮”的、也有说“皮草”的，说法不一。到底是叫裘皮公司、毛皮公司，还是皮草公司，其实追根溯源，“裘皮”、“毛皮”、“皮草”是在不同时期人们的不同称谓。
多层	多层，指“多层建筑”。一般指六层及以下的小区，多数户型为东西两户。多层住宅可以不设置电梯，楼梯往往作为多层住宅的主要上下楼通道，一般单价三楼价格最贵，其次为二四楼最贵。也有少数设置电梯的多层小区一般统称为多层洋房，次顶价格最贵。
裤女	百度百科是一部内容开放、自由的网络百科全书，旨在创造一个涵盖所有领域知识，服务所有互联网用户的中文知识性百科全书。在这里你可以参与词条编辑，分享贡献你的
笔记本	笔记本电脑（Laptop）又被称为“便携式电脑，手提电脑、掌上电脑或膝上型电脑”，其最大的特点就是机身小巧，相比PC携带方便，是一种小型、可便于携带的个人电脑，通常重1-3公斤。当前的发展趋势是体积越来越小，重量越来越轻，而功能却越发强大。为了缩小体积，笔记型电脑当今采用液晶显示器（也称液晶LCD屏）。除了键盘以外有些还装有触控板（Touchpad）或触控点（Pointing stick）作为定位设备（Pointing device）。笔记本跟PC的主要区别在于其携带方便，对主板，CPU要求，内存，显卡，硬盘容量都有不同等等。虽然笔记本的机身十分轻便，但完全不用怀疑其应用性，在日常操作和基本商务、娱乐 、运算操作中，笔记本电脑完全可以胜任。当今的笔记本电脑正在根据用途分化出不同的趋势，上网本趋于日常办公以及电影，商务本趋于稳定低功耗
火锅	火锅(英语：Hot Pot)，古称“古董羹”，因食物投入沸水时发出的“咕咚”声而得名，它是中国独创的美食，历史悠久，是一种老少皆宜的食物。周代的鼎器应是火锅最早的雏形，据考证，战国时期即有火锅，时人以陶罐为锅，到宋代，火锅的吃法在民间已十分常见，南宋林洪的《山家清供》食谱中，便有同友人吃火锅的介绍。元代，火锅流传到蒙古一带，用来煮牛羊肉。到清代，火锅不仅在民间流行，而且成了一道著名的“宫廷菜”，用料是山鸡等野味。火锅一般是指以锅为器具，以热源烧锅，以水或汤烧开
控油	控油指的是调整皮肤分泌的油脂含量。不管是中性皮肤，还是油性、混合性皮肤，一般都会出油，而容易出油的地方就是T区。一般的控油方法就是用控油产品和勤洗脸。
机车	机车：汉语名词机车：网络用语
真丝	真丝一般指蚕丝，包括桑蚕丝、柞蚕丝、蓖麻蚕丝、木薯蚕丝等。真丝被称为“纤维皇后”，以其独特的魅力受到古往今来的人的青睐真丝属于蛋白质纤维。蚕丝纤维是唯一得到实际应用的天然长丝纤维，由蚕改粘液凝固而成。蚕丝纤维因蚕的食性不同分成多种，其中有食桑叶形成的桑蚕丝纤维、食柞树叶形成的柞蚕丝纤维以及食木薯叶、马桑叶、蓖麻叶形成的其他野蚕丝纤维。桑蚕丝纤维和柞蚕丝纤维可以把长丝纤维的形态保留到集束形成的长丝纱中，其他的几种野蚕丝纤维只能被改形为短纤维用纺织加工。在用桑蚕丝纤维和柞蚕丝纤维集束形成的长丝纱中，桑蚕丝纤维的长丝纱最重要，占天然长丝纱的大部分。现以桑蚕丝纤维的组成与结构为例说明如下。
20	《二十》是由李炳宪编剧并执导，金宇彬、李俊昊、姜河那等主演的韩国喜剧电影。影片讲述三个刚满二十岁的男生面对全新的人生、爱情、友情所经历的成长故事。于2015年3月25日在韩国上映。该片最终票房达304万观影人次，位列韩国本土电影年度票房榜第十位。
仿古	仿古，指模仿古器物或艺术品，也指模仿前人。
被套	被套，俗称“被罩”，套在棉被外面，避免棉被弄脏，便于清洗。属于床上生活用品一类。
小童	小童，拼音是xǐao tóng，出自《石钟山记》，解释为幼童。
口袋	口袋，著名掌机游戏《Pocket Monster》（口袋妖怪）的汉译缩写。此外口袋指指缝在衣服上用以装东西的袋形部分，衣兜。或一种装物用具，一般用布、皮做成；用布、皮等做成的装东西的用具。可以比喻类似口袋的包围圈、口袋阵，也可以代指钱包。
专业	专业指的：(1) 专门从事某种学业或职业。(2) 专门的学问。(3) 高等学校或中等专业学校所分的学业门类。(4) 产业部门的各业务部分。(5) 是指一种物质或某种作业的作用范围。
持久	持久是一个汉语词汇，拼音是chí jiǔ，指维持长久；历久不变。语出《资治通鉴》“今寇众我寡，难与持久。”
架子	架子，指放东西的支撑物，支持藤本或其它植物的棚架，装模作样的自大神态或姿势。
设计师	《设计师》是2015年上映电影，影剧备字[2015]第4960号。
批发	批发(wholesaling) 是指将商品或服务售与那些为了将商品再出售或为企业使用的目的而购买的顾客时所发生的一切活动。从这个角度讲，一家面包零售店向当地一家旅馆出售糕点，该面包店就是在经营批发业务。但是，将使用批发商这个术语来描述那些主要从事批发活动的公司。它不包括制造商和农场主，因为它们主要从事生产，同时，它也不包括零售商。
小包	小包：子实体中的小体小包：小型的包小包：物流名词
特级	特级是一个词语，意思是特别高的等级。特指商品的质量和等级很高
花瓶	花瓶是一种器皿，多为陶瓷或玻璃制成，外表美观光滑；名贵者有水晶等昂贵材料制成用来盛放花枝的美丽植物,花瓶底部通常盛水，让植物保持生命与美丽。
雪地	雪地分为两种，一种为大陆型雪地，另一种为海洋型雪地
车用	百度百科是一部内容开放、自由的网络百科全书，旨在创造一个涵盖所有领域知识，服务所有互联网用户的中文知识性百科全书。在这里你可以参与词条编辑，分享贡献你的
奶粉	奶粉是将牛奶除去水份后制成的粉末，它适宜保存。奶粉是以新鲜牛奶或羊奶为原料，用冷冻或加热的方法，除去乳中几乎全部的水分，干燥后添加适量的维生素、矿物质等加工而成的冲调食品。
玫瑰	玫瑰（学名：Rosa rugosa Thunb.）：原产地中国。属蔷薇目，蔷薇科落叶灌木，枝杆多针刺，奇数羽状复叶，小叶5-9片，椭圆形，有边刺。花瓣倒卵形，重瓣至半重瓣，花有紫红色、白色，果期8-9月，扁球形。枝条较为柔弱软垂且多密刺，每年花期只有一次，因此较少用于育种，近来其主要被重视的特性为抗病性与耐寒性。玫瑰作为经济作物时，其花朵主要用于食品及提炼香精玫瑰油，玫瑰油应用于化妆品、食品、精细化工等工业。在欧洲诸语言中，蔷薇、玫瑰、月季都是使用同一个词，如英语是rose，德语是Die Rose。玫瑰是英国的国花。通俗意义中的“玫瑰”已成为多种蔷薇属植物的通称。且事实上杂交玫瑰也是由蔷薇属下各物种杂交选育所产生。此内容请看“玫瑰花”一词。
皮带	皮带，指皮质的腰带。 目前国际社会提倡环保，所以以PU皮带最流行，真皮皮带市场上越来越少。 我国是世界上最大的皮带出口国。 出口至欧盟和美国的皮带必须达到严格的环保无毒标准。 当前流行的皮革腰带为渐宽渐长式样的，并且一头宽，一头窄，宽的地方可达12厘米多，有闪亮的金属纽装饰，颜色多样化，如大红、湖蓝、魏紫、鹅黄、乳白等。
春秋装	春秋装 拼音： 解释： 春秋季节穿着的服装。主要品种有套装、长裙、茄克衫、风衣、毛衣等。款式一般以舒适、随便、自然为主，并日益注重套装的颜色和款式的流行趋势和内外衣的配套。
卫裤	卫裤通常是指由棉或涤纶这两种面料制作的运动裤。有的里面会加有拉绒以适应秋冬季节穿着。卫裤是那种底下是绒绒毛质地的面料的裤子。卫裤可以做成运动裤款式，也可以做成别的打底裤子的款式。
街头	[名]⑴ （形声。从行，圭声。“街”，小篆象纵横相交的十字路。本义：四路相通的大道）
椅子	椅子是一种日常生活家具，一种有靠背、还有扶手的坐具。古代席地而坐，原没有椅子。据文籍记载，椅子的名称始见于唐代，而椅子的形象则要上溯到汉魏时传入北方的胡床。而现代的椅子追求美观时尚，一些椅子不再单单是坐具赋予更多科技，使人类更方便。
可折叠	百度百科是一部内容开放、自由的网络百科全书，旨在创造一个涵盖所有领域知识，服务所有互联网用户的中文知识性百科全书。在这里你可以参与词条编辑，分享贡献你的
袋装	百度百科是一部内容开放、自由的网络百科全书，旨在创造一个涵盖所有领域知识，服务所有互联网用户的中文知识性百科全书。在这里你可以参与词条编辑，分享贡献你的
靠枕	汉族床上用品。呈正方体。由六块边长25厘米左右的方形布料缝制成枕套，内充荞麦皮或秕谷等物。可用各色花布拼缝，亦可用单色布料并刺绣以图案。图案常有“一帆风顺”、“二龙戏珠”、“三阳开泰”、“四季发财”、“五蝠捧寿”、“六合同春”等，寓吉祥、祝福之意。常用于人们和衣午休或临时性的垫背靠坐。
景德镇	景德镇，别名 “瓷都”，江西省地级市，位于江西省东北部，西北与安徽省东至县交界，南与万年县为邻，西同鄱阳县接壤，东北倚安徽省祁门县，东南和婺源县毗连。介于东经116°57′—117°42′，北纬28°44′—29°56′之间，总面积5256平方千米。景德镇市处于属于黄山、怀玉山余脉、鄱阳湖平原过渡地带。处于皖（安徽）、浙（浙江）、赣（江西）三省交界处，是浙赣皖重要的交通枢纽中心城市之一。民国时期曾与广东佛山、湖北汉口、河南朱仙并称全国四大名镇。2018年，景德镇市下辖2个市辖区、1个县级市、1个县，常住总人口为167.3213万人，实现地区生产总值（GDP）846.60亿元，其中，第一产业增加值56.45亿元，第二产业增加值402.32亿元，第三产业增加值387.83亿元，人均地区生产总值50723元。景德镇市是世界瓷都，中国直升机工业的摇篮。国务院首批公布的24座历史文化名城之一和国家甲
窗帘	窗帘是由布、麻、纱、铝片、木片、金属材料等制作的，具有遮阳隔热和调节室内光线的功能。布帘按材质分有棉纱布、涤纶布、涤棉混纺、棉麻混纺、无纺布等，不同的材质、纹理、颜色、图案等综合起来就形成了不同风格的布帘，配合不同风格的室内设计窗帘。窗帘的控制方式分为手动和电动。手动窗帘包括：手动开合帘、手动拉珠卷帘、手动丝柔垂帘、手动斑马帘、手动木百叶、手动罗马帘、手动风琴帘等等。电动窗帘包括：电动开合帘、电动卷帘、电动丝柔百叶、电动天棚帘、电动斑马帘、电动木百叶、电动罗马帘、电动风琴帘等等。随着窗帘的发展，它已成为居室不可缺少的、功能性和装饰性完美结合的室内装饰品。
正宗	词目“正宗”，读作“zhèng zōng”， 最早出于宋陈师道 《请兴化禅师疏》：“绍雪门之正宗，入 慧林之半座。”；后泛指学业技术的嫡传承继，也指传统的，主要的。刀名，由日本相州名刀工正宗作于镰仓末期，为正剑的代表，後来更成为权力授与的印信。“士郎正宗（Shirou Masamune）”，日本兵库县神户市人，“士郎正宗”是他的笔名，职业漫画家。作品都是关于高科技世界的影响与演变，也具有相当丰富的格斗场景。代表作品《苹果核战记》、《攻壳机动队1》等先后被动画化和电影化，受到不少影迷的欢迎。
男裤	最早的男裤应该是夏娃身穿得那套衣服吧，随着时间的推移，男裤的类型也丰富多彩，今天的主要流行的裤子也就是主流是牛仔裤、西裤、休闲裤等。
地毯	地毯，是以棉、麻、毛、丝、草等天然纤维或化学合成纤维类原料，经手工或机械工艺进行编结、栽绒或纺织而成的地面铺敷物。它是世界范围内具有悠久历史传统的工艺美术品类之一。覆盖于住宅、宾馆、体育馆、展览厅、车辆、船舶、飞机等的地面，有减少噪声、隔热和装饰效果。
围巾	围巾是围在脖子上的长条形、三角形、方形等形状，面料一般采用羊毛、棉、丝、莫代尔、人棉、腈纶、涤纶等材料，通常于保暖，也可因美观、清洁或是宗教而穿戴。
代购	代购，释义为代理购买。通俗意思就是找人帮忙购买你需要的商品，原因可以是你在当地买不到这件商品，可以是当地这件商品的价格比其他地区的贵，也可以是为了节省个人时间成本，请人帮忙买好送货上门。帮人从香港，澳门，台湾，甚至美国，日本，法国，韩国购买商品，然后通过快递发货或者直接携带回来，又或者从国内携带商品到国外给别人，就是常见的代购形式。还有一种代购，由于消费者对想要购买商品的相关信息的匮乏，自已无法确定其实际价值而又不想被商家宰，只好委托中介机构帮其讲价，或者干脆让中介机构代买。《中华人民共和国电子商务法》将于2019年1月1日正式实施。代购行为必须依法进行。
自制	自制是一个汉字词语，拼音是zì zhì，解释为指自行制订、自己制造、克制自己，出自典故《汉书·王吉传》，同义词有克己、便宜、公道。
bb	BIGBANG（빅뱅）是韩国YG Entertainment推出的五人男子演唱组合，现以G-DRAGON（权志龙）、T.O.P（崔胜铉）、TAEYANG（东永裴）、DAESUNG（姜大声）四位成员的形式展开活动。2006年8月19日，BIGBANG在YG Family世界巡回演唱会首尔站上正式出道，并于同年12月22日发行首张正规专辑《BIGBANGVOL.1 SINCE2007》。2007年5月，BIGBANG开始进行全国巡回演唱会，并于7月推出了第一张迷你专辑《Always》。2008年8月8日，BIGBANG发行MINI专辑《STAND UP》，专辑中的歌曲《一天一天》在KTF连续六周蝉联第一名。2009年，BIGBANG赴日本发展。2011年，BIGBANG成为历史上第一个获得MTV欧洲音乐大奖“Worldwide Act”的亚洲组合，并于2012年上半年登上美国格莱美官方网页，成
polo	Polo一词在英文中是马球（马球，史称“击鞠”、“击球”等，骑在马背上用长柄球槌拍击木球的运动。蒙古族民间马上游戏和运动项目，流行于内蒙古等地。相传唐初由波斯（今伊朗）传入，称“波罗球”，后传入蒙古，相沿至今。）的意思，而马球运动是一项贵族运动，参与者通常穿用的是源自网球衣的针织短袖运动衣。将这种运动衣演变成为大众服式，是拉尔夫·劳伦的功劳。这位才华卓著的设计师还将他的设计理念与风格融入到了POLO箱包、皮具、帽、眼镜等领域。
西服	西装又称作“西服”、“洋装”。西装是一种“舶来文化”，在中国，人们多把有翻领和驳头，三个衣兜，衣长在臀围线以下的上衣称作“西服”，这显然是中国人民对于来自西方的服装的称谓。
法式	拼音法式：fǎ shì释义法度，制度；标准的格式。出处《管子·明法解》：“案法式而验得失，非法度不留意焉。” 《史记·秦始皇本纪》：“驩欣奉教，尽知法式。” 《旧唐书·突厥传下》：“卿早归阙庭，久参宿卫，深感恩义，甚知法式，所以册立卿等各为一部可汗。”示例郭沫若《中国史稿》第三编第二章第二节：“它要求从中央到地方，从生产到生活，从行动到思想，‘皆有法式’，严格地符合封建制度。” 
两件	百度百科是一部内容开放、自由的网络百科全书，旨在创造一个涵盖所有领域知识，服务所有互联网用户的中文知识性百科全书。在这里你可以参与词条编辑，分享贡献你的
打孔	1、卷烟术语。在香烟或水松纸上打孔，以增加纸的空气通透能力和空气稀释度。2、书籍出版术语。指将活页卡片或各种单张本册页等，按一定规格在订口上打上可以穿联的孔眼（直径一般为3-5mm）。打孔的眼数一般为2个，也可根据需要或多或少。3、用带钻头的器具在固体或坚固材料中凿孔或钻孔洞。4、穿孔；穿刺做孔。5、面料风格加工工艺术语。在面料上面打上不同花型或者按一定规律分布的孔，从而显现出面料的不同风格样。6、在通信领域内，打孔(Puncturing)的意思是去冗余比特。
装饰画	装饰画（Decorative Painting）是一种集装饰功能与美学欣赏于一体的艺术品。随着科学技术的进步与发展，装饰画的载体与表现形式也愈来愈丰富，大大提高了当今人们对品质生活的追求和热爱。装饰画的起源可以追溯到新石器时代彩陶器身上的装饰性纹样，如动物纹、人纹、几何纹，都是经过夸张变形、高度提炼的图形。确切的讲是起源于战国时期的帛画艺术，一般分为具象题材、意象题材、花卉题材、人物肖像题材抽象题材和综合题材等等。洞窟壁画、墓室壁画、宫殿装饰壁画艺术对当今装饰画的影响也非常大。
纯手工	百度百科是一部内容开放、自由的网络百科全书，旨在创造一个涵盖所有领域知识，服务所有互联网用户的中文知识性百科全书。在这里你可以参与词条编辑，分享贡献你的
连体衣	哈衣，又称连身衣、连体衣、爬服，还没这个概念的，也是一种新式服装。棉质哈衣对宝宝的皮肤有很好的保护作用，睡觉时穿也可避免宝宝因踢被而使肚肚受凉，方便宝宝活动。
250g	百度百科是一部内容开放、自由的网络百科全书，旨在创造一个涵盖所有领域知识，服务所有互联网用户的中文知识性百科全书。在这里你可以参与词条编辑，分享贡献你的
低帮	百度百科是一部内容开放、自由的网络百科全书，旨在创造一个涵盖所有领域知识，服务所有互联网用户的中文知识性百科全书。在这里你可以参与词条编辑，分享贡献你的
猫咪	猫，属于猫科动物，分家猫、野猫，是全世界家庭中较为广泛的宠物。家猫的祖先据推测是起源于古埃及的沙漠猫，波斯的波斯猫，已经被人类驯化了3500年（但未像狗一样完全地被驯化）。一般的猫：头圆、颜面部短，前肢五指，后肢四趾，趾端具锐利而弯曲的爪，爪能伸缩。夜行性。以伏击的方式猎捕其他动物，大多能攀缘上树。猫的趾底有脂肪质肉垫，以免在行走时发出声响，捕猎时也不会惊跑鼠。行进时爪子处于收缩状态，防止爪被磨钝，在捕鼠和攀岩时会伸出来。
幼儿	幼儿，指1岁的孩子度过了婴儿期，进入了幼儿期。幼儿无论在体格和神经发育上还是在心理和智能发育上，都出现了新的发展。动作发育周岁的孩子已经能够行走了，这一变化使孩子的眼界豁然开阔。周岁的孩子开始厌烦母亲喂饭了，虽然自己能拿着食物吃得很好，但还用不好勺子。他对别人的帮助很不满意，有时还大哭大闹以示反抗。他要试着自己穿衣服，拿起袜子知道往脚上穿，拿起手表往自己手上戴，给他个香蕉他也要拿着自己剥皮。这些都说明孩子的独立意识在增强。
澳洲	澳大利亚联邦（英语：The Commonwealth of Australia），简称“澳大利亚”（Australia）。其领土面积7692024平方公里，位于南太平洋和印度洋之间，四面环海，是世界上唯一国土覆盖一整个大陆的国家，因此也称“澳洲”。拥有很多独特的动植物和自然景观的澳大利亚，是一个奉行多元文化的移民国家。澳大利亚（Australia）一词，原意为“南方的大陆”，由拉丁文 terraaustralis （南方的土地）变化而来。欧洲人在17世纪发现这块大陆时，误以为是一块直通南极的陆地，故取名“澳大利亚”。澳大利亚原为澳大利亚土著居住地。17世纪，西班牙、葡萄牙和荷兰殖民者先后抵此。1788年沦为英国殖民地，1901年组成澳大利亚联邦，成为英国的自治领。1931年成为英联邦内的独立国家。澳大利亚是一个高度发达的资本主义国家，首都为堪培拉。作为南半球经济最发达的国家和全球第12大
空调	空调即空气调节器（Air Conditioner）。是指用人工手段，对建筑/构筑物内环境空气的温度、湿度、洁净度、流速等参数进行调节和控制的设备。一般包括冷源/热源设备，冷热介质输配系统，末端装置等几大部分和其他辅助设备。主要包括，制冷主机、水泵、风机和管路系统。末端装置则负责利用输配来的冷热量，具体处理空气状态，使目标环境的空气参数达到要求。
沙滩	沙滩就是由于沙子淤积形成的沿水边的陆地或水中高出水面的平地。我国有名的沙滩有北海沙滩、三亚亚龙湾、中国第一长滩。
罐装	罐装 是一种承装物品的形式。罐子的发明已经很久了，也有很久的历史 。人们从很早就使用罐子来贮存储藏食品或者其他物品！
农家	农家，中国3D武侠动画《秦时明月》系列中的门派，历代首领均被称为农家侠魁。燕国豪侠田光曾作为农家侠魁，与楚国昌平君、燕国燕丹、项氏一族项燕共同策划过“青龙计划”。以田氏一族为主，后主要分裂为以烈山堂田氏一族和神农堂朱家为主的两派。（概述图为农家六堂六位现任堂主朱家、田虎、司徒万里、田仲、田蜜、田言及原魁隗堂堂主胜七）
营养	指人体消化、吸收、利用食物或营养物质的过程，也是人类从外界获取食物满足自身生理需要的过程，包括摄取、消化、吸收和体内利用等。
靠背	靠背：汉语词汇靠背：墨西哥文物靠背：苏见信演唱歌曲
奢华	奢华是一个汉语词汇，拼音是shē huá，意思是表示“奢侈浮华”，现在多形容有钱人的生活，也形容爱慕虚荣的人所渴望的生活。按目前现在的消费观和社会观来看，它其实是一个中性词，指的是一种生活态度，一种品位和格调的象征。出自唐韩愈《李花》诗之二：“当春天地争奢华，洛阳园苑尤纷拏。”
金属	本书研究并图解阐述了一系列现代金属材料，内容涵盖了不同功用的各种金属材料，包括建筑、工业用金属材料以及餐具产品等。书中每一页讲解一种材料、一种加工工艺或一件产品。作者:（英）克里斯·莱夫特瑞著；张港霞译 
香水	《香水》是由梦工厂和百代出品，汤姆·提克威执导，本·威士肖、达斯汀·霍夫曼等主演的剧情片。该片于2006年9月7日在德国上映。该片依据帕特里克·聚斯金德的同名小说改编而成，描述一位与人类不相往来、嗅觉异常灵敏的天才格雷诺耶，为了追寻世上最完美的香味而不惜杀人的旅程。该片获得第57届德国电影奖杰出故事片，最佳服装设计等六项奖项。
pu	聚氨酯材料是聚氨基甲酸酯的简称，英文名称是polyurethane，它是一种高分子材料。聚氨酯是一种新兴的有机高分子材料，被誉为“第五大塑料”，因其卓越的性能而被广泛应用于国民经济众多领域。产品应用领域涉及轻工、化工、电子、纺织、医疗、建筑、建材、汽车、国防、航天、航空等。
仿真	仿真（Simulation），即使用项目模型将特定于某一具体层次的不确定性转化为它们对目标的影响，该影响是在项目仿真项目整体的层次上表示的。项目仿真利用计算机模型和某一具体层次的风险估计，一般采用蒙特卡洛法进行仿真。
体恤	体恤，汉语词汇。拼音：tǐ xù释义：指替他人实际处境着想而怜悯、帮助。多用于尊长对后辈
书柜	书柜是 书房家具中的主要 家具之一，即专门用来存放 书籍、 报刊、 杂志等书物的 柜子。许多消费者总是丢三落四， 书籍乱扔乱放，让居室生活变得一团糟。而这个时候，如果有了书柜，把全部书整理在书柜里面，让居室生活一下子变得干净明了。
马克杯	马克杯是一种杯子类型，指大柄杯子，因为马克杯的英文叫mug，所以翻译成马克杯。马克杯是家常杯子的一种，一般用于牛奶、咖啡、茶类等热饮。西方一些国家也有用马克杯在工作休息时喝汤的习惯。杯身一般为标准圆柱形或类圆柱形，并且杯身的一侧带有把手。马克杯的把手形状通常为半环，通常材质为纯瓷、釉瓷、玻璃，不锈钢或塑料等。也有少数马克杯由天然石制成，一般价格较高。
妈妈	《妈妈》是由美国环球影业发行的恐怖惊悚片，由安德斯·穆斯切蒂执导，杰西卡·查斯坦、尼可拉·科斯特-瓦尔道、梅根·查彭提尔、伊莎贝尔·内利瑟联合主演。该片于2013年1月18日在美国上映。该片根据导演安德斯·穆斯切蒂的同名短片改编，故事围绕一对女孩展开，讲述了她们在一次车祸中消失在森林——直到五年后才被发现，迁出了一连串恐怖事件的故事。
麻辣	麻辣，是川菜常用味道之一。特点是麻辣味厚，咸鲜而香。广泛应用于以家禽、家畜、内脏以及干鲜蔬品、豆类与豆制品等为原料的冷、热菜式，如水煮肉片、麻婆豆腐、麻辣牛肉丝、牛舌莴笋、麻辣鸡片、毛肚火锅等，主要由辣椒、花椒、川盐、味精和料酒调制而成。
钓鱼	钓鱼执法，在法理上，当事人原本没有违法意图，在执法人员的引诱之下，才从事了违法活动；在行政执法上，与刑事侦查中的“诱惑侦查”，或者叫“诱惑取证”类似。钓鱼执法，英美叫执法圈套（entrapment），这是英美法系的专门概念，它和正当防卫等一样，都是当事人无罪免责的理由。国家当然应该惩罚这种行为。这种行为如果运用不当将致人犯罪，诱发严重社会问题。钓鱼执法是政德摧毁道德的必然表现。从历史上看，一些案情复杂、取证难的案件，往往采取钓鱼执法（英美叫执法圈套（entrapment）的方式。美国是钓鱼执法实施比较多的国家，也留下了很多著名的案例。但钓鱼执法具有某种诱导性，一直以来也饱受争议。世界各国执法机关也都使用类似手段，比如警察扮演瘾君子向毒贩购买毒品。但“诱捕”有着严格的控制要求，是有一定前提的。也就是说，所设之套本身不能成为控告罪犯的证据。大陆法系国家对此也有严格限制，日本法律禁止执法者为了取
背景墙	背景墙，外文名Background wall，是一种装饰于家庭客厅电视、沙发、玄关、卧室墙等的家庭装修艺术，风格多样，以其新颖的构思、先进的工艺，不但满足了消费者装饰装修的需要，更体现了艺 术的气质，使之成为商业与艺术的完美结合，居室色彩选择搭配应以符合主人的心理感受为原则。背景墙具有吸音、隔音、吸波功能，也可以应用于旅馆、饭店、KTV、夜总会等娱乐场所的装修装饰，还可以应用于演艺厅、电影院、歌剧院、视听室、演播厅、录音室等吸音隔音要求专业的墙面装饰上。
雪纺	雪纺是丝产品中的纱（不是纺）类产品，名称来自英语Chiffon的音译，意为轻薄透明的织物，具有织物轻薄、透明、柔软、飘逸的特点。近几年来，由于化纤技术的飞速发展，由“化纤”替代了原来的“真丝”。其手感、风格非常接近或类似，所以常常把雪纺说成真丝雪纺或者化纤雪纺。
面霜	面霜、乳液是基础护肤最重要的一步了，面霜、乳液中的美白、抗衰老等有效成分能够更好的被肌肤吸收，所以，拥有一瓶好的面霜/乳液可是非常重要的。护肤步骤是 ：卸妆、清洁、祛角质、按摩、凝露、面膜、化妆水、眼霜、乳液、面霜、隔离霜、防晒。
移动	移动含义指改换原来的位置。
拆洗	拆洗，指把[棉衣、棉被等]拆开洗净，再缝上。
wifi	Wi-Fi（发音： /ˈwaɪfaɪ/，法语发音：/wifi/），在中文里又称作“行动热点”，是Wi-Fi联盟制造商的商标做为产品的品牌认证，是一个创建于IEEE 802.11标准的无线局域网技术。基于两套系统的密切相关，也常有人把Wi-Fi当做IEEE 802.11标准的同义术语。“Wi-Fi”常被写成“WiFi”或“Wifi”，但是它们并没有被Wi-Fi联盟认可。并不是每样匹配IEEE 802.11的产品都申请Wi-Fi联盟的认证，相对地缺少Wi-Fi认证的产品并不一定意味着不兼容Wi-Fi设备。IEEE 802.11的设备已安装在市面上的许多产品，如：个人计算机、游戏机、MP3播放器、智能手机、平板电脑、打印机、笔记本电脑以及其他可以无线上网的周边设备。Wi-Fi联盟成立于1999年，当时的名称叫做Wireless Ethernet Compatibility Alliance（WE
圆头	圆头，指手柄后顶端，这是个老式英文词；圆头发型，又称卡尺头，卡尺”的意思大概就是指其长短一致，就像是用“卡尺”量过的一样。
不粘锅	不粘锅即做饭不会粘锅底的锅，是因为锅底采用了不粘涂层，常见的、不粘性能最好的有特氟龙涂层和陶瓷涂层。其次还有特殊工艺的铁锅和不锈钢锅。不粘锅的问世给人们的生活带来了很大的方便，人们不必再提心煮肉时一不小心就会烧焦，煎鱼时鱼片粘在锅壁上。这种不粘锅与普通锅的外型无关，只在锅的内表面多涂了一层聚四氟乙烯，利用聚四氟乙烯优异的性能制成了这种深受欢迎的厨房用具。
短裙	短裙，是一种围于下体的服装，略呈环状，为下装的两种基本形式（另一种为裤装）之一，广义上包括连衣裙、衬裙、腰裙。古谓下裳，古时男女同用，今多为女性穿着。
女生	1.仍然处在受教育阶段的未婚适龄女性学生。2.雌性人类。3.戏曲表演中的专有名词，指由女性扮演的生旦净末丑中的“生角”，故称女生。
流苏	蔷薇属月季栽培品种。
伸缩	伸缩，伸展与收缩。引申指行动﹑动作。
原宿	原宿，是东京都涩谷区的一个地区，范围约为明治神宫、代代木公园、竹下通、表参道、国立代代木竞技场一带，是日本著名的“年轻人之街”，东京时尚的核心秘密，走在这里的每一个潮人和街区里的一切，完美地组成了一个充满活力的“时尚生态圈”。原宿和代官山、涩谷一起被称为是东京街头文化的代表，聚集了很多时尚前卫的店铺和一群追捧它们的年轻人，所以街头的行人就是时尚的载体。从原宿站周边到表参道周边范围的泛用地名。在1965年（昭和40年）被废弃的町名。区域范围相当于从原宿一丁目到三丁目，表参道北侧，神宫前一丁目到四丁目，原宿站（旧时町名是隐田三丁目）和竹下通周边算町域外。此区域范围内主要有三车站：JR原宿站（山手线）、东京地铁明治神宫前站（千代田线、副都心线）、东京地铁表参道站（银座线、千代田线、半藏门线）。
亚麻	亚麻（学名：Linum usitatissimum L. ）：是一年生草本植物，可分成纤维用亚麻、油用亚麻和油纤兼用亚麻三种类型。茎直立，可达1.2米高，上部细软，有蜡质；叶互生，披针状，20-40毫米长，3毫米宽，表面有白霜；花的花瓣5，直径为15-25毫米，蓝色或白色；果实为蒴果，种子扁卵圆形，喜凉爽湿润气候。亚麻是人类最早使用的天然植物纤维，距今已有1万年以上的历史。亚麻是纯天然纤维，由于其具有吸汗、透气性良好和对人体无害等显著特点，越来越被人类所重视。同时，亚麻还是油料作物，亚麻油含多量不饱和脂肪酸，故用来预防高血脂症和动脉粥样硬化。亚麻起源于近东、地中海沿岸。早在5000多年前的新石器时代，瑞士湖栖居民和古代埃及人。已经栽培亚麻并用其纤维纺织衣料，埃及各地的“木乃伊”也是用亚麻布包盖的。亚麻喜凉爽、湿润的气候。亚麻纤维具有拉力强、柔软、细度好、导电弱、吸水散水快、膨胀率大等特点，
茶盘	茶盘是用来置茶杯的，材质广泛，款式多样，圆月形、棋盘形……等等。但不管什么材质和式样，最重要也是四字诀：宽、平、浅、白。就是盘面要宽，以便就客人人数多寡，可以放多几个杯。盘底要平，才不会使茶杯不稳，易于摇晃；边要浅，色要白，这都是为了烘托茶杯、茶壶，使之雅观。
泡茶	泡茶是中国人的发明，是中国茶文化发展的拐点，带动了茶具、茶道、茶艺、茶文化的发展。泡茶讲究茶具、用水、水温、环境、心境、甚至着装（礼服）等等。在泡茶之前，人们只会把茶叶放在嘴里咀嚼。在泡茶之后，茶饮才真正实现了普及，成为中国人和世界各地茶人的至爱。茶相关经典名句：“一器成名只为茗，悦来客满是茶香。”
婚庆	婚庆，具体来说指的是婚礼庆典策划。 婚礼策划是指为客人量身打造的婚礼。它涵盖各种婚礼形式或是各种婚礼形式的组合体，它是根据每位新人的不同爱好、追求或诉求点而不同为新人量身定做的婚礼。婚庆包括，婚纱摄影，婚宴酒席，婚庆策划，主持司仪，婚车出租，婚礼跟拍，婚礼摄像，蜜月旅游等相关行业。
2019	2019是2018与2020之间的自然数，属于奇数，也是一个年份。
官网	官方，一般解释为政府方面，古代指设官府。又指掌控权利的一方，官网是官方网站的简称，一般指的是公司的“官方”网站。1 1、指由网站主题代表者所设置的网站，有别于网友为兴趣设置的网站。如：电影公司为介绍某部新片所设置的网站，即可称为该影片的「官方网站」。 2、网站主题的地区代理商，所制作的网页，也可以称做官方网页。如：韩国在线游戏由台湾代理，台湾代理商做的网页就称为「台湾区的官方网页。」 3、泛指政府部门所置的网站，又可以细分为以下差别： 【官方】：公家方面的部门，多指政府。 【半官方】：含有民间势力的官方机构。 【非官方】：全部为民间势力的机构。 
骨瓷	近日，由香港著名导演陈伟强监制，陈玉冰担任总制片人，林华全导演，王婉中、王佑硕主演，周海媚，洪晓静友情出演的首部灵欲爱情电影《骨瓷》在广州开机。
秋衣	秋衣是指秋冬季节穿的一种长袖舒适贴身的服装，一般穿在外衣或者毛衣等的里面。
儿童玩具	儿童玩具是指专供儿童游戏使用的物品。玩具是儿童把想象、思维等心理过程转向行为的支柱。儿童玩具能发展运动能力，训练知觉，激发想象，唤起好奇心，为儿童身心发展提供了物质条件。儿童玩具的种类主要有：形象玩具、技术玩具、拼合和装配玩具、建筑和结构玩具、体育活动玩具、音乐发声玩具、劳动活动玩具、装饰性玩具和自制玩具等。对玩具的一般教育要求是：有利于促进幼儿体、德、智、美的全面发展；符合儿童年龄特征，能满足其好奇心、好动和探索活动的愿望；造型优美，反映事物的典型特征；活动多变，有助于鼓励学习；符合卫生要求，色彩无毒，易于清洁、消毒；符合安全要求等。
小米	北京小米科技有限责任公司成立于2010年3月3日，是一家专注于智能硬件和电子产品研发的移动互联网公司，同时也是一家专注于高端智能手机、互联网电视以及智能家居生态链建设的创新型科技企业。小米公司创造了用互联网模式开发手机操作系统、发烧友参与开发改进的模式。小米还是继苹果、三星、华为之后第四家拥有手机芯片自研能力的科技公司。“为发烧而生”是小米的产品概念。“让每个人都能享受科技的乐趣”是小米公司的愿景。小米公司应用了互联网开发模式开发产品的模式，用极客精神做产品，用互联网模式干掉中间环节，致力让全球每个人，都能享用来自中国的优质科技产品。
盘子	盘子，指盛放物品(多为食物）的浅底的器具，比碟子大，多为圆形。多数为陶瓷品，也有金属制品，可以在上面放东西。用盘子盛菜时，夹起菜来比较方便，散热也比较好。在西方，是常用的餐具之一，除了盆子之外，西方人就用它来盛食物，因此，盘子对西方人来说十分重要。
海鲜	海鲜（hoisin），又称海产食物，包括了鱼类、虾类、贝类这些海产等。虽然海带这类海洋生物也常是被料理成食物，但是海鲜主要还是针对动物制成的料理为主。狭义上，只有新鲜的海产食物才能称为海鲜，海鲜的分类有：活海鲜、冷冻海鲜。
挂画	戏剧《挂画》是本戏《梵王宫》中的一折，梆子戏中常见的剧目，是蒲剧（蒲州梆子）的代表作。秦腔，晋剧，京剧，红梅戏等剧目也曾移植这一剧目。
挂钟	挂钟最早是由塔钟演变而来，大约在16世纪欧洲出现庞大体积的塔钟建筑，限于当时的制造技术，钟表一般体积较大。随着技术发展，在20世纪中期日本的石英钟技术的突破以及在钟表上的应用。小型挂钟在千家万户中普及。目前挂钟有三大类：1、指针式石英挂钟 2、机械式挂钟 3、数字式挂钟。有的门厅及房间挂钟是必须的，特别是综合办公室，更应该挂时钟，因为在这些地方挂时钟可有五大作用，一是招财进宝，二是避邪气，三是助主人运势，四是管理部下，五是计时间。但是，时钟的挂法若不明理气，挂错地方就不行了，时钟的正面不能向内，应朝向门或阳台的方向为好。挂钟兼具看时间和艺术品味的融合，一款艺术挂钟更能体现出主人的艺术修养以及营造艺术氛围。
定做	定做是汉语词汇，拼音dìng zuò，解释为一定做成。
手链	手链是一种首饰，配戴在手腕部位，多为金银等金属制品，也有矿石、水晶等制的。手链是链状的，以祈求平安，镇定心志和美观为主要用途。
双肩	百度百科是一部内容开放、自由的网络百科全书，旨在创造一个涵盖所有领域知识，服务所有互联网用户的中文知识性百科全书。在这里你可以参与词条编辑，分享贡献你的
帆布	帆布（canvas）是一种较粗厚的棉织物或麻织物，因最初用于船帆而得名。一般多采用平纹组织，少量的用斜纹组织，经纬纱均用多股线。帆布通常分粗帆布和细帆布两大类。粗帆布又称蓬盖布，具有良好的防水性能，最大的特点就是结实耐用，用于汽车运输和露天仓库的遮盖以及野外搭帐篷。细帆布用于制作劳动保护服装及其用品，经染色或印花后，也可用作鞋材、箱包面料、手袋、背包、桌布、台布等等。此外，还有橡胶帆布，防火、防辐射用的屏蔽帆布，造纸机用的帆布。
黑白	围棋，是一种策略型两人棋类游戏，中国古时称“弈”，西方名称“Go”。流行于东亚国家（中、日、韩、朝），属琴棋书画四艺之一。围棋起源于中国，传为帝尧所作，春秋战国时期即有记载。隋唐时经朝鲜传入日本，流传到欧美各国。围棋蕴含着中华文化的丰富内涵，它是中国文化与文明的体现。围棋使用方形格状棋盘及黑白二色圆形棋子进行对弈，棋盘上有纵横各19条线段将棋盘分成361个交叉点，棋子走在交叉点上，双方交替行棋，落子后不能移动，以围地多者为胜。因为黑方先走占了便宜，所以人为规定黑方局终时要给白方贴子。中国古代围棋是黑白双方在对角星位处各摆放两子（对角星布局），为座子制，由白方先行。现代围棋取消了座子规则，黑先白后，使围棋的变化更加复杂多变。围棋也被认为是世界上最复杂的棋盘游戏。
三合一	该片是最早与中国观众见面的澳大利亚译制片。影片由“一车木柴”、“裘·威尔生的伙伴”、“城市”等三个小故事组成，讲述了澳大利亚工人之间相互友爱的故事。
吸顶灯	吸顶灯是灯具的一种，顾名思义是由于灯具上方较平，安装时底部完全贴在屋顶上所以称之为吸顶灯。光源有普通白灯泡，荧光灯、高强度气体放电灯、卤钨灯、LED等。目前市场上最流行的吸顶灯就是LED 吸顶灯，是家庭、办公室、文娱场所等各种场所经常选用的灯具。
丝绒	丝绒是割绒丝织物的统称。表面有绒毛，大都由专门的经丝被割断后所构成。由于绒毛平行整齐，故呈现丝绒所特有的光泽。如立绒、乔其绒等。多作服装及装饰用。
女夏	百度百科是一部内容开放、自由的网络百科全书，旨在创造一个涵盖所有领域知识，服务所有互联网用户的中文知识性百科全书。在这里你可以参与词条编辑，分享贡献你的
鸭绒	鸭绒是长在鸭的腹部，成芦花朵状的绒毛，成片状的叫羽毛。由于羽绒是一种动物性蛋白质纤维，球状纤维上密布千万个三角形的细小气孔，能随气温变化而收缩膨胀，产生调温功能，可吸收人体散发流动的热气，隔绝外界冷空气的入侵。
甜美	该品种属早熟小型西瓜品种。春季全生育期90-110天，秋季全生育期70-80天，植株生长势中强，抗病性中强，较易坐果，果实椭圆形，表皮绿底墨绿粗散条带（虎皮），果肉大红，肉质实脆，果皮硬韧，耐贮运性好。中心可溶性固形物含量11.3%，果实商品率89.1%，平均单瓜重3.25公斤。
手套	手套是手部保暖或劳动保护用品，也有装饰用的。手套是个很特别的东西，当初它的产生并不是为了实用，只是到近代，它才成了寒冷地区保温必备之物，或是医疗防菌、工业防护用品。但是除了传统意义上的手套，现在的手套更有了深一层的含义，与传统的手套迥然不同。这是由于网络游戏的兴起，使得铺天盖地的游戏装备名称出现，由于游戏玩家数量众多，尤其是相比于传统行业，使得网络上的手套信息更多的却是网络游戏装备的相关信息，手套最早起源于古希腊。
工具	工具原指工作时所需用的器具，后引申为达到、完成或促进某一事物的手段。工具是一个相对概念，因为其概念不是一个具体的物质，所以只要能使物质发生改变的物质，相对于那个能被它改变的物质而言就是工具。
耐热	耐热，heat resistance，是指在高温下具有高的抗氧性、抗蠕变性与强度持久的特性。
餐桌椅	餐桌椅是指餐厅里面吃饭时需要的桌椅，市场上出售的餐桌，以原木色泽的为最多，分为实木和人造板两种；另外，透明玻璃面餐桌底座为大理石或金属等材质的餐桌也占有一定的市场份额。
法兰绒	法兰绒(Flano，Flannel)一词系外来语，是一种用粗梳（棉）毛纱织制的柔软而有绒面的（棉）毛织物。于18世纪创制于英国的威尔士。国内一般是指混色粗梳（棉）毛纱织制的具有夹花风格的粗纺（棉）毛织物，其里面有一层丰满细洁的绒毛覆盖，不露织纹，手感柔软平整，身骨比麦尔登呢稍薄。
积木	积木通常是立方的木头或塑料固体玩具，一般在每一表面装饰着字母或图画，容许进行不同的排列或进行建筑活动积木有各种样式，可开发儿童智力，可拼成房子，各种动物等。
增高	增高是指在青少年期间父母对孩子们的希望，通过药物、食物等各种方式变高的方式。长高是指生物从小变高大的过程，是细胞分裂增生演变的结果，在这个长高的过程中，地球上所有生物（包括人）都离不开营养的吸收，庄稼长高需要肥料，动物长高需要喂饲料，人类长高通过补充人体长高所需的31种营养实现长高。一个人从出生到成熟大约需要20年时间。过程相当缓慢，但只有这样才符合大自然生物生长的规律，也是唯一安全有效的长高办法。
玻璃杯	玻璃杯（glass）是指玻璃制成的杯子，通常由原材料高硼硅玻璃，经过600多度的高温烧制而成，它是新型的环保型茶杯，越来越受到人们的青睐。
初学者	《初学者》是薛之谦演唱的歌曲，由薛之谦创作词曲，收录于薛之谦2016年7月18日发行的专辑《初学者》。2016年，该歌曲获得全球流行音乐金榜“2016上半年度20大金曲奖”。2017年1月，获得Billboard Radio China 2016年度华语十大金曲奖。
皮夹克	皮夹克是采用动物皮，如猪皮、牛皮、羊皮、蛇皮、鱼皮等动物皮，经过特定工艺加工成的皮革做成的衣服。
面膜	面膜，是护肤品中的一个类别，是美容保养品的一种载体，敷在脸上用于美容功能例如补水保湿、美白、抗衰老、平衡油脂等等。
被子	被子是床上用品的一种，是面积足以覆盖人体、长方形的布料，一般用作睡眠时保暖，被子通常由被套或者被单包着棉絮而成，用棉做的被子叫做棉被。除棉被外，也可以用羊毛、蚕丝或者丙烯酸纤维等人造纤维制造。
护肤品	护肤品，即保护皮肤的产品。随着社会经济的不断进步和物质生活的丰富，护肤品，不再是过去只有富人才用的起的东西。现如今护肤品已走进了平常百姓家。它对人们的精神、形象提升起到了极大的作用。
机械表	机械表（mechanical watch ）通常可分为下列两种：手动上链及自动上链手表（AUTOMATIC）两种。这两款机械的动力来源皆是靠机芯内的发条为动力，带动齿轮进而推动表针，只是动力来源的方式有异。手动上链的机械表是依靠手动拧动发条作动力，机芯的厚度较一般自动上发条的表薄一些，相对来说手表的重量就轻。而自动上链的手表，是利用机芯的自动旋转盘左右摆动产生动力来驱动发条的，但相对来讲手动上链手表的厚度要比自动上链的小一些。
干货	干货是一个电子商务术语，指电子商务从业工作者发表、分享的一些关于网络推广、网络营销工作知识经验和工作方法的文章，因为这些知识和方法都是实用性比较强的，不含吹水成分，也没有虚假的成分，所以业内人士通常把这一类分享活动称之为干货 。该词现已延伸至各行各业使用，可用于表示某人传授的知识、方法、技能等比较重要或者比较实用。譬如老师讲课内容比较实用，我们可以称之为干货。某师傅教的技术比较实用，我们也可以称之为干货。比如，电子商务实战专家“小A”把自己的百度百科和百度知道优化的工作内容整理成通俗易懂的文章发表后，大家线下聚会、或在QQ群一起讨论分享的时候，大家就会说这次“小A”分享的内容全是干货。也就是说大家都有收获，都能把分享的东西成功运用到实战中去。这是一种对他人肯定的表述。
脚蹬	脚蹬子的杠杆：指的是那个踩在脚底下的，别看这个东东很小，其实它是一个等臂杠杆。
口红	口红是一类唇用美容化妆品，其主要功能是赋予嘴唇以色调，强调或改变两唇的轮廓，显示出更有生气和活力。早在公元前3500年，人类便已开始使用一些带色的矿物和植物色素涂抹在面颊和唇上，以达到美容的目的。随着美容化妆品的发展，口红的色调、配方和功能都有较大的变化。口红的色调与女性的发型、指甲油色调和服装变化密切相关，变得更具有潮流色彩。特别是近年来各种珠光粉和处理颜料的使用，使口红的色调更加多样化，质感更加舒适。与其他美容化妆品的发展趋势相似，它继续保持美容为主，兼顾保湿、滋养和防晒功能。口红配方、原料和工艺的进展推动着口红工业的发展。
披肩	披肩也叫云肩，多以丝缎织锦制作，大多数云肩用四个云纹组成，叫四合如意式，还有柳叶式、荷花式等等，上面都有吉祥命题，例如富贵牡丹、多福多寿、连年有鱼等等。明清的时候流行很多，大多都在婚庆喜宴等社交场合使用。
鼠标	鼠标，计算机的一种输入设备，也是计算机显示系统纵横坐标定位的指示器，因形似老鼠而得名（港台作滑鼠）。其标准称呼应该是“鼠标器”，英文名“Mouse”，鼠标的使用是为了使计算机的操作更加简便快捷，来代替键盘那繁琐的指令。鼠标是1964年由加州大学伯克利分校博士道格拉斯·恩格尔巴特（Douglas Engelbart）发明的，当时道格拉斯·恩格尔巴特在斯坦福研究所(SRI)工作，该研究所是斯坦福大学赞助的一个机构，Douglas Engelbart
西裤	西裤主要指与西装上衣配套穿着的裤子。由于西裤主要在办公室及社交场合穿着，所以在要求舒适自然的前提下，在造型上比较注意与形体的协调。裁剪时放松量适中，给人以平和稳重的感觉。西裤在生产工艺及造型上基本已国际化和规范化。西短裤与西裤的工艺基本相同，长度在膝盖以上不等，可根据自己的需要选择。
花盆	花盆（英文名：flower pot），种花用的一种器皿，为口大底端小的倒圆台或倒棱台形状。种植花卉的花盆形式多样，大小不一。花卉生产者或养花人士可以根据花卉的特性和需要以及花盆的特点选用花盆，根据制作材料不同，可以分为很多种。
开叉	开叉，读音kāi chā，汉语词语，指在衣服下部边缘开口儿，多在两侧或后身。
自行车	自行车，又称脚踏车或单车，通常是二轮的小型陆上车辆。人骑上车后，以脚踩踏板为动力，是绿色环保的交通工具。英文bicycle。其中bi意指二，而cycle意指轮，即两轮车。在中国内地、台湾、新加坡，通常称其为“自行车”或“脚踏车”；在港澳则通常称其为“单车”（其实粤语通常都这么称呼）；而在日本称为“自転（转）车”。自行车种类很多，有单人自行车，双人自行车还有多人自行车。可以作为环保的交通工具用来代步、出行；越来越多的人将自行车作为健身器材用来骑行锻炼、自行车出游；自行车本身也是一项体育竞技运动，有公路自行车赛、山地自行车赛、场地自行车赛、特技自行车比赛等。
低音炮	低音炮是大家的一个俗称或者简称，严格讲应该是：重低音音箱。重低音其实是电子音乐里，低音音乐的一个叫法。这个词语第一次是被创新开发出来的，而“低音炮”这一个乡土化特色的词语则是由麦蓝（即现在的麦博）开创性地提出的。就人耳可闻的音频分析而言，由重低音、低音、低中音、中音、中高音、高音、超高音等组成，有强化音节节奏的效果。简单讲，低音是声音的基本框架，中音是声音的血肉，高音是声音的细节反映。重低音喇叭人耳的可闻是极其有限的，反而是人的其它感官会感受得到，这就是震撼的感觉！就音响与家庭影院反映的音频节目源的需要来说，重低音只是在特定的节目源存在并需要还原的，有它，可以使节目源的还原更加结实，无它，就给人缺乏力量、能量的感觉。比如，在电影院或者在现实中，我们能够感受得到飞机起飞时那种力量与能量的震撼，但是如果我们的家庭影院没有配置重低音喇叭音箱或者配置不合理，人们就无法感受这种震撼，但也仅此而已。
平板	平板泛指平板电脑（英文：Tablet Personal Computer，简称Tablet PC、Flat Pc、Tablet、Slates），是一种小型、方便携带的个人电脑，以触摸屏作为基本的输入设备。它拥有的触摸屏（也称为数位板技术）允许用户通过触控笔或数字笔来进行作业而不是传统的键盘或鼠标。用户可以通过内建的手写识别、屏幕上的软键盘、语音识别或者一个真正的键盘（如果该机型配备的话）。平板电脑由比尔·盖茨提出，应支持来自高通骁龙处理器，Intel、AMD和ARM的芯片架构，平板电脑分为ARM架构（代表产品为iPad和安卓平板电脑）与X86架构（代表产品为Surface Pro和Wbin Magic）后者X86架构平板电脑一般采用intel处理器及Windows操作系统，具有完整的电脑及平板功能，支持exe程序。
调料	调料是人们用来调制作食品等的辅助用品。它包括各种酱油、食盐、酱味等单一调味料及鸡精调味料等复合调味料。调料有以下几种：咸味调料、甜味调料、酸味调料、辣味调料、鲜味调料等。
嘻哈	嘻哈（hip hop）诞生于美国贫民区街头的一种文化形式，一般的说法认为它诞生于美国纽约布朗克斯。嘻哈首先在纽约市北部布朗克斯市区的非裔及拉丁裔青年之间兴起，继而发展壮大，并席卷全球。2018年1月，广电总局发布了最严的禁令，明确规定节目中纹身艺人、嘻哈艺人、亚文化（非主流文化）、喊麦、丧文化（颓废文化）不得请用。嘻哈四大支柱为DJ（打碟），MC（说唱），Graffiti（涂鸦）,Breaking 和 Knowledge（知识）。
套餐	套餐，原只指一整套的饭，后来也指一系列的活动等。套餐的种类很多，比如gprs套餐，肯德基套餐，小灵通套餐，神州行套餐，联通98元G网套餐，移动套餐，鸭鲜知营养套餐等等。在套餐中，卖方根据预期的目标来组合不同规格的产品打包销售来满足要求，买方可按个人的消费标准或口味喜好来选择适合自己的组合套餐品种。
摆设	摆设，指陈设；陈设之物。也比喻指空有形式而不起实际作用的东西。语出元关汉卿 《金线池》第四折：“摆设箇大大筵席，但是他家亲眷……都请将来饮宴。”
徒步	徒步（Tramp），是指有目的的在城市的郊区、农村或者山野间进行中长距离的走路锻炼，徒步是户外运动最为典型和最为普遍的一种。由于短距离徒步活动比较简单，不需要太讲究技巧和装备，经常也被认为是一种休闲的活动。徒步也是平民的代称。见《汉书·公孙弘传》：“起徒步，数年至宰相，封侯。”
正版	正版即“正确地使用版权”。而版权是属于版权所有人的，版权所有人提出使用条件，使用者只要符合条件，就算是正确地使用，就不违反版权法。企业通过开发产品，经过合法注册，受知识产权保护，进而生产产品获利。
铅笔	铅笔（qiān bǐ，Pencil），是一种用来书写以及绘画素描专用的笔类，距今已有四百多年的历史，其中，绘画素描的铅笔分为诸多类型，它分成三个发展阶段，分为石墨、木制笔杆、带帽铅笔；另外，它的颜色有红白、黑白、黄黑等条纹。
直邮	直邮（Direct Mail）英文简称DM，指具有个人资讯（ Personal Information ）的功能，通过 DM 的媒体进行寄递，创造顾客的一种方式。简单理解， DM 就是一种广告宣传的手段。目前，DM 已被大部分企业作为商务活动的首选措施，其低廉的成本及极强的针对性、亲切感和真实性，受到企业经营者的青睐。
直营	直营，就是指由公司总部直接投资经营，这种以一个品牌为主导，在各地投资设立分公司或子公司的经营管理模式，相对于特许加盟连锁模式来说，称为直营公司连锁模式。直营模式是实力雄厚的大型企业通过吞并、独资、控股等途径，发展壮大自身实力和规模的一种形式。
安卓	Android是一种基于Linux的自由及开放源代码的操作系统。主要使用于移动设备，如智能手机和平板电脑，由Google公司和开放手机联盟领导及开发。尚未有统一中文名称，中国大陆地区较多人使用“安卓”。Android操作系统最初由Andy Rubin开发，主要支持手机。2005年8月由Google收购注资。2007年11月，Google与84家硬件制造商、软件开发商及电信营运商组建开放手机联盟共同研发改良Android系统。随后Google以Apache开源许可证的授权方式，发布了Android的源代码。第一部Android智能手机发布于2008年10月。Android逐渐扩展到平板电脑及其他领域上，如电视、数码相机、游戏机、智能手表等。2011年第一季度，Android在全球的市场份额首次超过塞班系统，跃居全球第一。 2013年的第四季度，Android平台手机的全球市场份额已经达到78
飘窗	飘窗，一般呈矩形或梯形向室外凸起，三面都装有玻璃。飘窗有内飘和外飘两种类型，外飘是凸的，内飘是平凹的，外飘窗一般三面都是玻璃窗，凸出墙体，底下是凌空的，内飘窗一般都有一面玻璃，两面是墙，比较安全，但是会占用室内的空间。大块采光玻璃和宽敞的窗台，使人们有了更广阔的视野，更赋予生活以浪漫温馨的色彩。飘窗，从名字不难看出，就是飘出的窗子。一般的飘窗可以呈矩形或梯形，从室内向室外凸起。飘窗的三面都装有玻璃，窗台的高度比起一般的窗户较低。这样的设计既有利于进行大面积的玻璃采光，又保留了宽敞的窗台，使得室内空间在视觉上得以延伸。一般的窗户都是做在墙体的垂直平面以内，要是把窗户突出到墙外面，就成了飘窗了。现在流行的飘窗一般可以分为两种形态，第一种是带台阶的，另一种则是落地的。飘窗不仅可以增加户型的采光和通风等功能，也给商品房的外立面增添了建筑魅力。正是基于此，有关飘窗面积的计算问题，也就成为业主们关注的
法国	法兰西共和国（法语：République française，英语：French Republic），简称“法国”（France），是一个本土位于西欧的半总统共和制国家，海外领土包括南美洲和南太平洋的一些地区。法国为欧洲国土面积第三大、西欧面积最大的国家，东与比利时、卢森堡、德国、瑞士、意大利接壤，南与西班牙、安道尔、摩纳哥接壤。本土地势东南高西北低，大致呈六边形，三面临水，南临地中海，西濒大西洋，西北隔英吉利海峡与
红酒	红酒（Red wine）是葡萄酒的一种，并不一定特指红葡萄酒。红酒的成分相当简单，是经自然发酵酿造出来的果酒，含有最多的是葡萄汁，葡萄酒有许多分类方式。以成品颜色来说，可分为红葡萄酒、白葡萄酒及粉红葡萄酒三类。其中红葡萄酒又可细分为干红葡萄酒、半干红葡萄酒、半甜红葡萄酒和甜红葡萄酒，白葡萄酒则细分为干白葡萄酒、半干白葡萄酒、半甜白葡萄酒和甜白葡萄酒。粉红葡萄酒也叫桃红酒、玫瑰红酒。杨梅酿制的叫做杨梅红酒。还有一种蓝莓酿制的蓝莓红酒。
遥控	动词，本指通过通信媒体对远距离被控对象进行控制的技术，由操作装置、编码装置、发送装置、信道、接收装置、译码装置和执行机构等组成。后来也可以引申到其他方面，比喻对事情不直接出面指挥而在远处进行操纵。
送礼	送礼，传统意义上都是送些实物的东西。送礼是普遍存在的社会现象，它存在于人类社会的各个时期、各个地区。一件理想的礼品 对赠送者和接受者来说，都能表达出某种特殊的愿望，传递出某种特殊的信息
香薰	一切经由皮肤系统和呼吸系统传达精油等药用功效的芳香疗法都可以称之为香薰。通常广义香薰又包含所有的芳香疗法，因此香薰的方式种类繁多，如自然薰蒸、按摩、沐浴等等。人们通过按摩、吸入、热敷、浸泡、蒸薰，使芳香精油（也称植物精油）快速融入人体血液及淋巴液中，可以加速体内新陈代谢，促进活细胞再生，增强身体免疫力，进而调节人体神经系统、循环系统、内分泌系统、肌肉组织、消化系统及排泄系统等。常用香薰油泡浴、按摩，再配上轻柔的音乐，鼻间嗅入清新甜美的花香， 沁入骨髓，暗香浮动，令您拥有迷人和浪漫的气质。香薰护理风靡全球，倍受爱美女士青睐。它能舒心养颜，放松减压。纯植物精油中含有许多酚多精，能够刺激体内的自律神经，让内分泌系统稳定，自然神清气爽，活力大增。香薰是一种另类的穿着艺术，没有香味的女人就如没有糖的咖啡，淡而无味。香薰的最高境界乃身、心、灵（Body, Mind, Spirit）合一。香薰精油大多从
包女	百度百科是一部内容开放、自由的网络百科全书，旨在创造一个涵盖所有领域知识，服务所有互联网用户的中文知识性百科全书。在这里你可以参与词条编辑，分享贡献你的
爸爸	爸爸，对指有子女的男性（父亲）的一种称呼，多用于口语。该词起源甚早，在成书于三国魏明帝太和年间的《广雅》中《释亲》篇已有云：“爸，父也。”在金庸先生的武侠小说中，也可见到多以“爸爸”称呼父亲，而非“爹爹”，比如杨过即是如此，那是因为该词的确在宋之前已流存于世了。现在大众的“爹爹”“娘亲”的古代称呼印象主要来自于影视剧等，一知半解，不知孰之过也。现代人大多数是叫“爸爸”。湖北、西北、安徽等地也称父亲不是老大的为“达达”，比爸爸小的也叫“达达”。
阿迪达斯	adidas（阿迪达斯）创办于1949年，是德国运动用品制造商阿迪达斯AG成员公司。以其创办人阿道夫·阿迪·达斯勒（Adolf Adi Dassler）命名，1920年在黑措根奥拉赫开始生产鞋类产品。1949年8月18日以adidas AG名字登记。阿迪达斯原本由两兄弟共同开设，在分道扬镳后，阿道夫的哥哥鲁道夫·达斯勒 （Rudolf Dassler）开设了运动品牌puma。其经典广告语：“没有不可能”（Nothing is impossible）。2011年3月，斥资1.6亿欧元启用全新口号——adidas is all in（全倾全力）。2017年6月，adidas入选《麻省理工科技评论》2017 年度全球50 大最聪明公司”榜单。2018年7月19日，2018年《财富》世界500强排行榜发布，adidas位列480位。2018年12月，世界品牌实验室编制的《2018世界品牌500强》
代餐	所谓代餐（又名替餐、代餐食品），顾名思义就是取代部分或全部正餐的食物，常见的代餐形式有代餐粉、代餐棒、代餐奶昔以及代餐粥等。代餐除了能够快速、便捷的为人体提供大量的各种营养物质外，具有高纤维、低热量、易饱腹等特点。如利用魔芋为原料生产的鲜花派、五谷杂粮辗磨的杂粮粉。代餐的产品有许多型态，当做卡路里控制餐使用时，所有代餐都有相同的效果，因此在选择代餐时，要选最适合自己口味、食用时机及脂肪含量最少的产品，并在食用前先详读标示，才能发挥代餐的效果。代餐食品的加工工艺有铜锅炒制、石磨辗轧、低温烘焙、开水冲泡、等等。
宿舍	“宿舍”是住宿的房屋，包括寝室、卫生间、洗浴间、阳台等。宿舍住的人数不同，有单人间，双人间，多人间等。不同学校有不同规格的宿舍，而宿舍所支持的设备也不同，电器要求不同。
桌椅	桌：几案，可用于饮食、读书、写字：桌案。饭桌、方桌、圆桌、会议桌。椅：有靠背的坐具：椅子。坐椅。木椅。躺椅。
卫浴	卫浴按字面意思就是卫生、洗浴，卫浴俗称主要用于洗澡的卫生间，是供居住者便溺、洗浴、盥洗等日常卫生活动的空间及用品。现阶段卫浴又不仅仅是单一卫浴这么简单，随着人们生活节奏的加快，对于各种产品的要求提高，出现了彩色卫浴用品。
提亮	百度百科是一部内容开放、自由的网络百科全书，旨在创造一个涵盖所有领域知识，服务所有互联网用户的中文知识性百科全书。在这里你可以参与词条编辑，分享贡献你的
整理	整理：常用于表示：去除不需要的东西。整理，著作权法术语，指对内容零散、层次不清的已有文字作品或者材料进行条理化、系统化的加工，如古籍的校点、补遗等。
荷叶	荷叶为睡莲科植物莲Nelumbo nucifera Gaertn的叶。荷花一般长到150厘米高，横向扩展到3米。荷叶最大可达直径60厘米，莲花最大直径可达20厘米。
风格	风格是艺术概念，艺术作品在整体上呈现的有代表性的面貌。风格不同于一般的艺术特色，通过艺术品所表现出来的相对稳定、内在、反映时代、民族或艺术家的思想、审美等的内在特性。本质在于是艺术家对审美独特鲜明的表现，有着无限的丰富性。艺术家由于不同的生活经历、艺术素养、情感倾向、审美的不同，形成受到时代、社会、民族等历史条件的影响。题材及体裁、艺术门类对作品风格也有制约作用
小熊	小熊：一款壁纸美化类软件小熊：漫画《尸兄》中的角色小熊：《女神异闻录4》中角色小熊：茶凉粉鼓手
通勤	通勤是日制汉语，指从家中往返工作地点的过程。一般来说，通勤在日语中是大众词汇，但在汉语中，通勤是铁路方面的术语。通勤是工业化社会的必然现象。在19世纪以前，市民主要步行上班。现时如汽车、火车、公共汽车、自行车等交通工具让住在较远处的人可以快捷地上班。
吸管	吸管，英文straw，或称饮管，是一条圆柱状，中空的塑胶制品，其主要功用是用来饮用杯子中饮料，也有用来吸食一些烹饪好的动物长骨的骨髓。一般直径在0.5cm左右，但是用来吸食酸奶、珍珠奶茶等饮品时，会用较粗的吸管，有的直径有1.2cm。一些较少见，直径极小的吸管用作饮热饮。
泰国	泰王国（泰语：ราชอาณาจักรไทย，英语：The Kingdom of Thailand），简称“泰国”（Thailand）。是一个位于东南亚的君主立宪制国家。泰国位于中南半岛中部，其西部与北部和缅甸、安达曼海接壤，东北边是老挝，东南是柬埔寨，南边狭长的半岛与马来西亚相连。泰国旧名暹罗，1949年5月11日，泰国人用自己民族的名称，把“暹罗”改为“泰”，主要是取其“自由”之意。泰国实行自由经济政策，在20世纪90年代经济发展较快，跻身成为“亚洲四小虎”之一，但于“九八经济危机”中受重大挫折，之后陷入衰退和停滞。是世界的新兴工业国家和世界新兴市场经济体之一。制造业、农业和
拼色	百度百科是一部内容开放、自由的网络百科全书，旨在创造一个涵盖所有领域知识，服务所有互联网用户的中文知识性百科全书。在这里你可以参与词条编辑，分享贡献你的
毛绒玩具	毛绒玩具（plush toy），是由毛绒面料与pp棉及其他纺织材料为主要面料，内部填塞各种填充物而制成的玩具，也可以称为软性玩具（soft toy）、填充玩具（stuffed toy），我国的广东及港澳地区称为“毛绒公仔”。当前我们习惯性的把布绒玩具业称为毛绒玩具。毛绒玩具具有造型逼真可爱、触感柔软、不怕挤压、方便清洗、装饰性强、安全性高、适用人群广泛等特点。因此毛绒玩具用于小孩子的玩具、装饰房屋及作为礼物送人都是很好的选择。
整装	整装：中国纺织出版社出版图书整装：蔡淳佳演唱歌曲
遮光	《遮光》是连载于起点中文网的网络小说，作者是长刀明月。
沥水	沥水是一个汉语词汇，意思是积在地面上的雨水。
新生	《新生》是意大利诗人但丁早期的代表作，记述他对贝雅特丽齐（后来成为他一生的缪斯）的爱情和她芳魂早逝的悲剧。
速食	百度百科是一部内容开放、自由的网络百科全书，旨在创造一个涵盖所有领域知识，服务所有互联网用户的中文知识性百科全书。在这里你可以参与词条编辑，分享贡献你的
炖锅	炖锅就是锅的一种分类，但功耗比电饭煲等电锅要小很多，工作时，热量由加热源通过水缓慢而均匀地渗透至陶瓷炖盅中的食物，使炖品营养成份不会因过热而破坏，炖盅盖的优良设计，能有效地防止营养成份的流失。
钢圈	简介钢圈(Wheel Rim)：大多数车辆所使用的钢圈为钢材压制及焊接而成，目前的钢圈外环制造的很精确，以装配无内胎的轮胎。钢圈生产过程:下料→卷圆→整圆→双切→对口→手工焊→抛光→清渣→扩张→收缩→冲气门孔→车钢圈 辐板下料→成型→冲中心孔→冲风孔→扩孔→车加工→冲气门孔→打磨 组装：装辐→检验→自动焊→酸洗磷化→阴极电泳→烤漆→检验→入库钢圈生产设备：型材轮辋卷圆机 本机适用于型材轮辋的卷圆，卷制范围为16-22吋；只需更换辊子和调整辊间距离即可对不同型号的型钢进行不同直径的卷圆。 轮辋刮渣机 主要用于型材轮辋对焊后的焊渣清理，刮去内外焊缝高出轮辋的多余金属，保证轮辋光洁平整；机器结构，气动离合。 板材轮辋卷圆机 本机适用于板材的卷圆，卷制时不需要更换辊子，只要调整辊间距离即可卷制不同直径的轮辋。 板材轮辋滚型机 本机适用于对板材轮辋卷圆后的滚型. 
小号	小号（英文名：Trumpet）又名小喇叭，是铜管乐器中的一种。在所有的铜管乐器里，小号的发音及声音是最高的。小号使用五线谱的高音谱表记谱。用固定唱名法，即固定高音概念进行演奏。当今世界上有降B，D，降E，E、F，G，A，高音（高八度）降B等多种调的小号，这些调是根据演奏第一泛音列的高音来确定的。我们通常使用的小号是降B调的。如果小号同钢琴，电子琴等这些C调乐器在一起演奏同一旋律时，小号必须提高大二度，也就是C调乐器演奏。
英寸	英寸（吋）是使用于联合王国(UK,即英国(英联邦)及其前殖民地的长度单位，一般为1in=2.54cm，在英制里，12英寸为1英尺，36英寸为1码。
转角	转角中文念作zhuǎnjiǎo，名词，一般指街巷等的拐弯处。有5个涵义：转变乐调的角音，拐弯，交点转角等。
酒店	酒店（又称为宾馆、旅馆、旅店、旅社、商旅、客店、客栈，台湾作饭店，港澳、马来西亚、新加坡等作酒店）其基本定义是提供安全、舒适，令利用者得到短期的休息或睡眠的空间的商业机构。一般地说来就是给宾客提供歇宿和饮食的场所。具体地说饭店是以它的建筑物为凭证，通过出售客房、餐饮及综合服务设施向客人提供服务，从而获得经济收益的组织。酒店主要为游客提供住宿服务、亦生活的服务及设施（寝前服务）、餐饮、游戏、娱乐、购物、商务中心、宴会及会议等设施。
键盘	键盘是用于操作设备运行的一种指令和数据输入装置，也指经过系统安排操作一台机器或设备的一组功能键（如打字机、电脑键盘）。键盘也是组成键盘乐器的一部分，也可以指使用键盘的乐器，如钢琴、数位钢琴或电子琴等，键盘有助于练习打字。键盘是最常用也是最主要的输入设备，通过键盘可以将英文字母、数字、标点符号等输入到计算机中，从而向计算机发出命令、输入数据等。还有一些带有各种快捷键的键盘，但起初这类键盘多用于品牌机，并曾一度被视为品牌机的特色。随着时间的推移，渐渐的市场上也出现独立的具有各种快捷功能的产品单独出售，并带有专用的驱动和设定软件，在兼容机上也能实现个性化的操作。也可当做笔记本电脑和ipad的外设连接设备。
垫子	百度百科是一部内容开放、自由的网络百科全书，旨在创造一个涵盖所有领域知识，服务所有互联网用户的中文知识性百科全书。在这里你可以参与词条编辑，分享贡献你的
气垫	气垫qìdiàn[air cushion]∶一种可以注入空气的橡皮垫子，放在卧床病人的受压部位下缓解压力[air cushion]∶从气垫船底喷出的高压气流，船身即因此悬浮
磨毛	磨毛是纺织业中的一种工艺，是布料通过磨毛机和金刚砂皮的磨擦作用，使织物表面形成了一层具有短绒毛层感觉，既保留原有特性又赋予织物新的风格，增加了保暖性和柔软性，厚厚柔柔，质感丰盈，具有不掉色的特性，颜色历久弥新，适用于冬季保暖性产品以及贴身使用的产品。
大礼包	百度百科是一部内容开放、自由的网络百科全书，旨在创造一个涵盖所有领域知识，服务所有互联网用户的中文知识性百科全书。在这里你可以参与词条编辑，分享贡献你的
男包	这个名词是箱包的性别分类衍生词。有性别区分并仅限于符合男性审美观的箱包统称为男包。男包也是男性的随身装饰品之一。
座椅	座椅是一种有靠背、有的还有扶手的坐具。古代席地而坐，原没有椅子，“椅”本是木名。
换鞋	《换鞋》是陈华杰平安夜生创作的网络小说，发表于小说阅读网。
1.2	百度百科是一部内容开放、自由的网络百科全书，旨在创造一个涵盖所有领域知识，服务所有互联网用户的中文知识性百科全书。在这里你可以参与词条编辑，分享贡献你的
音乐	音乐是反映人类现实生活情感的一种艺术（英名称：music；法文名称： musique；意大利文：musica）。音乐可以分为声乐和器乐两大类型，又可以粗略的分为古典音乐、民间音乐、原生态音乐、现代音乐（包括流行音乐）等。在艺术类型中，音乐具有抽象性，音乐从历史发展上可分为东方音乐和西方音乐。东方以中国汉族音乐为首的中国古代理论基础是五声音阶，即宫、商、角、徵、羽，西方是以七声音阶为主。音乐让人赏心悦目，并为大家带来听觉的享受。音乐能提高人的审美能力，净化人们的心灵，树立崇高的理想。我们通过音乐来抒发我们的情感，使我们的很多情绪得到释放。
抽屉式	百度百科是一部内容开放、自由的网络百科全书，旨在创造一个涵盖所有领域知识，服务所有互联网用户的中文知识性百科全书。在这里你可以参与词条编辑，分享贡献你的
hifi	Hi-Fi是英语High-Fidelity的缩写，翻译为“高保真”，其定义是：与原来的声音高度相似的重放声音。评价一个音响系统或设备是否符合高保真要求，一般应采用主观听音评价和客观指标测试相结合的方式来进行，并以客观测试指标为主要依据。因为采用仪器测试设备的性能指标，能得到很直观的可供参考比较的定量结果，无疑是最科学而值得信赖的。
马桶	马桶也叫坐便器，是大小便用的有盖的桶。马桶的发明被称为一项伟大的发明，它解决了人自身吃喝拉撒的进出问题。后来又逐渐演变为利用虹吸、螺旋虹吸，现在最新的喷射虹吸式和超旋虹吸式等原理的抽水马桶。也有人认为抽水马桶是万恶之源，因为它消耗了大量的生活用水。马桶的分类很多，有分体的，连体的。随着科技的发展，还出现了许多新奇的品种。根据马桶盖的配套方式，还可分为普通马桶和智能马桶。智能马桶还可进一步分为自动换套智能马桶和非自动换套马桶，前者包含自动换套加冲洗、自动换套带冲洗和烘干等不同种类。马桶的历史可以追溯到汉朝，当时的马桶叫虎子，是皇帝专用的，传说是玉制的。由专门服侍皇帝的太监抱着，以备皇帝随时方便之用。后来到了唐朝，因为皇帝家族中有个人叫李虎，为了避讳，就把虎子改名为兽子或者马子。再之后，在流传中，就演化成了马桶的称呼。
华为	华为技术有限公司是一家生产销售通信设备的民营通信科技公司，于1987年正式注册成立，总部位于中国广东省深圳市龙岗区坂田华为基地。华为是全球领先的信息与通信技术（ICT）解决方案供应商，专注于ICT领域，坚持稳健经营、持续创新、开放合作，在电信运营商、企业、终端和云计算等领域构筑了端到端的解决方案优势，为运营商客户、企业客户和消费者提供有竞争力的ICT解决方案、产品和服务，并致力于实现未来信息社会、构建更美好的全联接世界。2013年，华为首超全球第一大电信设备商爱立信，排名《财富》世界500强第315位。截至2016年底，华为有17万多名员工，华为的产品和解决方案已经应用于全球170多个国家，服务全球运营商50强中的45家及全球1/3的人口。2016年8月，全国工商联发布“2016中国民营企业500强”榜单，华为以3950.09亿元的年营业收入成为500强榜首。8月，华为在"201
过滤	是一大类单元操作的总称。[filter;filterate] 通过特殊装置将流体提纯净化的过程，过滤的方式很多，使用的物系也很广泛，固-液、固-气、大颗粒、小颗粒都很常见。过滤是在推动力或者其他外力作用下悬浮液（或含固体颗粒发热气体）中的液体（或气体）透过介质，固体颗粒及其他物质被过滤介质截留，从而使固体及其他物质与液体（或气体）分离的操作。
周岁	周岁，是国际通用的年龄计算方式。它计算的是出生后已经度过的时间长度（以出生时是零岁为基数，故也可以计算尾数，如三岁零两个月，七岁半等）。在中国，为了与传统的计龄方式进行区分，即计算出生后正在经历的年份次序（为序数），才有了周岁和虚岁这两种名称。注：每到公历生日的当天便增龄一岁。这种计龄方式是公认的传统，无需法律规定。在中国，出于减少纠纷的考虑，对于犯罪的未成年人，相关法律以推迟一天来计算周龄，这仅是特例而已。（《最高人民法院关于审理未成年人刑事案件具体应用法律若干问题的解释》第二条明确规定，“周岁”，按照公历的年月日计算，从周岁生日的第二天起算。）
中国	中国，是以华夏文明为源泉、中华文化为基础，并以汉族为主体民族的多民族国家，通用汉语、汉字，汉族与少数民族被统称为“中华民族”，又自称为炎黄子孙、龙的传人。中国是世界四大文明古国之一，有着悠久的历史，距今约5000年前，以中原地区为中心开始出现聚落组织进而形成国家，后历经多次民族交融和朝代更迭，直至形成多民族国家的大一统局面。20世纪初辛亥革命后，君主政体退出历史舞台，共和政体建立。1949年中华人民共和国成立后，在中国大陆建立了人民代表大会制度的政体。
大气	大气是指包围地球的气体，也泛指包围其他星球的气体。现也很多人用来指心胸宽广。
民族	民族，指在文化、语言、历史与其他人群在客观上有所区分的一群人，是近代以来通过研究人类进化史及种族所形成的概念。由于历史的原因，一个国家可以有不同民族，一个民族可以生活在不同的国家里。现代的民族概念，可以是以国度为区分的人群，也可以是单指有共同的文化概念，而没有共同的语言、历史来源的人群。现代同一个民族可有不同的宗教信仰；同一个民族也可有不同的历史渊源，不同的民族也可用相同的语言；不同的民族也可在后期融合成新民族。国族：国族是以政治凝结成的新族群，在文化习俗的融合的情况下，国族不可以直接转化成民族概念。典型的国族概念有巴西民族、美利坚民族，中华民族等。从2016年1月1日起，中国公民在年满18周岁的两年内，可以依据其父或者其母的民族成份申请变更一次。
腕表	手表，或称为腕表，是指戴在手腕上，用以计时/显示时间的仪器，手表在英语里watch源自中世纪wacche这一词汇。手表通常是利用皮革、橡胶、尼龙布、不锈钢等材料，制成表带，将显示时间的“表头”束在手腕上。
圣诞节	圣诞节（Christmas）又称耶诞节，译名为“基督弥撒”，它源自古罗马人迎接新年的农神节，与基督教本无关系。在基督教盛行罗马帝国后，教廷随波逐流地将这种民俗节日纳入基督教体系，同时以庆祝耶稣的降生。但在圣诞节这天不是耶稣的生辰，因为《圣经》未有记载耶稣具体生于哪天，同样没提到过有此种节日，是基督教吸收了古罗马神话的结果。大部分的天主教教堂都会先在12月24日的平安夜，亦即12月25日凌晨举行子夜弥撒，而一些基督教会则会举行报佳音，然后在12月25日庆祝圣诞节；基督教的另一大分支——东正教的圣诞节庆则在每年的1月7日。圣诞节也是西方世界以及其他很多地区的公共假日，例如：在亚洲的中国香港和澳门地区、马来西亚、新加坡。 
美的	美的集团（SZ.000333）是一家集消费电器、暖通空调、机器人与自动化系统、智能供应链（物流）的科技集团。美的集团提供多元化的产品和服务，包括以厨房家电、冰箱、洗衣机、及各类小家电的消费电器业务、以家用空调、中央空调、供暖及通风系统的暖通空调业务；以德国库卡集团、美的机器人公司等为核心的机器人及工业自动化系统业务、以安得智联为集成解决方案服务平台的智能供应链业务。美的集团以“科技尽善，生活尽美”为企业愿景，将“联动人与万物，启迪美的世界”作为使命，致力创造美好生活。美的于1968年成立于中国顺德，现总部位于广东顺德北滘新城内。迄今已建立遍布全球业务平台。美的在世界范围内拥有约200家子公司、60多个海外分支机构及10个战略业务单位，同时为德国库卡集团最主要股东（约95%）。2015年1月8日，《房间空气调节器节能关键技术研究及产业化》获得“国家科技进步奖”二等奖。2016年7月20日，美
泳衣	泳衣多指女性游泳时的专用衣服，也有男性泳衣。泳衣与体操衣不同，一般泳衣浸入水中不会下沉。泳衣一般多采用遇水不松垂、不鼓胀的纺织品制成。
隔断	隔断：隔断是指专门作为分隔室内空间的立面，应用更加灵活，如隔墙、隔断、活动展板、活动屏风、移动隔断、移动屏风、移动隔音墙等，源于日本技术。活动隔断具有易安装、可重复利用、可工业化生产、防火、环保等特点。
木床	百度百科是一部内容开放、自由的网络百科全书，旨在创造一个涵盖所有领域知识，服务所有互联网用户的中文知识性百科全书。在这里你可以参与词条编辑，分享贡献你的
优雅	优雅是一个汉语词汇，拼音是yōu yǎ。具体意思：（指物）优美雅致。 如优雅动听、环境优雅；（指人）优美高雅。如姿态优雅、举止优雅。通常说：某人言谈举止非常优雅。优雅是一种和谐，类似于美丽，只不过美丽是上天的恩赐，而优雅是艺术的产物。优雅从文化的陶冶中产生，也在文化的陶冶中发展。
背带	背带，拼音bēidài，出自《黎明的河边·主人》。
束脚	百度百科是一部内容开放、自由的网络百科全书，旨在创造一个涵盖所有领域知识，服务所有互联网用户的中文知识性百科全书。在这里你可以参与词条编辑，分享贡献你的
烧烤	烧烤（Grill，Barbecue），可能是人类最原始的烹调方式，是以燃料加热和干燥空气，并把食物放置于热干空气中一个比较接近热源的位置来加热食物。一般来说，烧烤是在火上将食物（多为肉类，海鲜，蔬菜）烤熟，烹调至可食用；现代社会，由于人类发明了多种用火方式，烧烤方式也逐渐多样化，发展出各式烧烤炉、烧烤架、烧烤酱等烧烤用品。烧烤本身也成为一种多人聚会休闲娱乐方式或者是生意。不论在中国还是整个亚洲、美洲和欧洲，烧烤通常是小至家庭，大至学校的集体活动以及一些公司组织的集体活动。
50	50是美国国防部作战计划或概念计划中的前两位数字，用来指代朝鲜半岛的作战暗号。
盆栽	盆栽定义是指栽在盆里的，有生命的植物总称；盆栽必须是活体植物，不同于盆花（可以是仿真花）。
地垫	地垫是一种能有效地在入口处刮除泥尘和水份，保持室内地面整洁的产品。特点是弹性柔软，脚感舒适，含有独特的抗紫外线添加剂，防止褪色及脆化现象，能承受日晒雨淋的室外环境。
靴女	百度百科是一部内容开放、自由的网络百科全书，旨在创造一个涵盖所有领域知识，服务所有互联网用户的中文知识性百科全书。在这里你可以参与词条编辑，分享贡献你的
点心	点心是糕点之类的食品。相传东晋时期一大将军，见到战士们日夜血战沙场，英勇杀敌，屡建战功，甚为感动，随即传令烘制民间喜爱的美味糕饼，派人送往前线，慰劳将士，以表“点点心意”。自此以后，“点心”的名字便传开了，并一直延用至今。
港风	港风，服装品牌，由天津立凤服装服饰有限公司出品。
喇叭	喇叭分为几种不同的乐器，一种管乐器，上细下粗，多用铜制成。另一种是现代的电声元件，作用是将电信号转换为声音，也叫扬声器。 还可用来形容替人鼓吹、宣传的人。
减震	减震，即建筑减震（结构消能减震）技术。
篮球	篮球，英文（basketball），起源于美国马萨诸塞州，是1891年12月21日由詹姆斯·奈史密斯创造，是奥运会核心比赛项目，是以手为中心的身体对抗性体育运动。1891年12月21日，由美国马萨诸塞州斯普林菲尔德基督教青年会训练学校（现译名为美国春田大学，Springfield College）体育教师詹姆士·奈史密斯发明。1896年，篮球运动传入中国，并且2002年姚明以状元的身份入选NBA，开启了中国篮球新的狂潮。1904年，圣路易斯奥运会上第1次进行了篮球表演赛。1936年，篮球在柏林奥运会中被列为正式比赛项目。1992年，巴塞罗那奥运会开始，职业选手可以参加奥运会篮球比赛。主要的国际性篮球组织是成立于1932年总部设在瑞士日内瓦的国际篮球联合会（
全铜	百度百科是一部内容开放、自由的网络百科全书，旨在创造一个涵盖所有领域知识，服务所有互联网用户的中文知识性百科全书。在这里你可以参与词条编辑，分享贡献你的
男式	百度百科是一部内容开放、自由的网络百科全书，旨在创造一个涵盖所有领域知识，服务所有互联网用户的中文知识性百科全书。在这里你可以参与词条编辑，分享贡献你的
电脑桌	电脑桌是一种用来放电脑的桌子。是很重要的办公及生活用品。现代的电脑桌款式多样质材多样，设计也多样化。随着社会和科技的进步，电脑桌的款式设计也是日新月异。
学院	学院（英文名：College、Institute或Academy）主要指门类科目较少、专业性强的高等教育机构。学院可以作为独立的学校，同时很多大学也拥有自己下属的二级学院（与系相同）或普通高等学校与国家机构以外的社会组织或者个人合作设置的独立学院。
盒装	百度百科是一部内容开放、自由的网络百科全书，旨在创造一个涵盖所有领域知识，服务所有互联网用户的中文知识性百科全书。在这里你可以参与词条编辑，分享贡献你的
布鞋	布鞋，顾名思义，即用布制作的鞋。 布鞋在我国有着3000多年的悠久历史。据考证，最早的手工布鞋是在山西侯马出土的西周武士跪像所穿的布鞋。2009年，“千层底手工布鞋制作技艺”被文化部列入《国家级非物质文化遗产》名录，从而将这项古老的手工技艺保护起来。如今，布鞋正在时尚转身成为“中国鞋”的代表，回归到每个国人的日常生活当中。
香辣	香辣是因为辣椒过油后产生的.化学原理暂时不明.请后来者解释,找不到图谢谢.
石英表	石英表是腕表种类之一，英文名是quartz watch。 将石英晶体运用在钟表上是一种现代的发明，世界上第一个石英表是瑞士在1967年7月制成的。在1969年，日本精工Seiko以领先全球的技术，推出世界上第一只可供量产的石英腕表，命名为“Quartz Astron”。
情侣装	情侣装，是一个现代词汇，是指情侣双方穿的一对的衣服，可以是一样的，也可以是一对的，是表达情侣双方爱情的一种服装。情侣装，是现在很受大众情侣欢迎的服装类型之一。
亲子	在这里，“子”是指孩子，“亲”就是指孩子以外的家庭内部成员，主要指孩子的双亲。亲子教育不同于我们通常理解的以家长为中心的“家庭教育”和以儿童为中心的“儿童教育”，其核心内容是父母与其子女相互尊重、共同教育、一起成长。 亲子教育是指通过对父母的培训和提升而达到的对亲子关系的调适，从而更好地促进儿童身心健康、和谐地发展的一种培训方式。
野生	野生是一个词组，意思是动植物在野外自然生长而非经人工驯养或培植。
登山鞋	登山鞋是专门为爬山和旅行而设计制造的鞋子，非常适合户外运动。防水性是现代登山鞋的首要功能，其防水透气性是一般运动鞋无法比拟的。在20世纪80年代中后期的中国，穿着各类运动鞋日益成为流行的时尚，随后军靴也加入其中。这时运动鞋被称为“旅游鞋”成为旅行者们的选择对象，军靴则成为那些酷爱野外生存和户外运动者的首选用品。其实无论是运动鞋（主要是慢跑鞋或网球鞋）还是军靴都不是非常适合户外运动的。从上个世纪开始，欧洲就已开始流行专门为爬山和旅行而设计制造的专业登山鞋。
项链	《项链》是法国作家莫泊桑创作于1884年的短篇小说。故事讲述了小公务员的妻子玛蒂尔德为参加一次晚会，向朋友借了一串钻石项链，来炫耀自己的美丽。不料，项链在回家途中不慎丢失。她只得借钱买了新项链还给朋友。为了偿还债务，她节衣缩食，为别人打短工，整整劳苦了十年。最后，得知所借的项链原是一串假钻石项链。《项链》采用了以物写人的手法，将项链作为一条主线，从它与人物的多重关系出发，用它牢牢系住人物的行为、语言和心理活动，使读者透过项链对女主人公的形象一目了然。
双排	百度百科是一部内容开放、自由的网络百科全书，旨在创造一个涵盖所有领域知识，服务所有互联网用户的中文知识性百科全书。在这里你可以参与词条编辑，分享贡献你的
桑蚕丝	桑蚕丝，是熟蚕结茧时分泌丝液凝固而成的连续长纤维，也称“天然丝”,很多生产企业又称为“蚕丝棉”。它与羊毛一样，是人类最早利用的动物纤维之一，根据食物的不同，又分桑蚕、柞蚕、木薯蚕、樟蚕、柳蚕和天蚕等。从单个蚕茧抽得的丝条称为茧丝，它由两根单纤维借丝胶粘合包覆而成。将几个蚕茧的茧丝抽出，借丝胶粘合包裹而成的丝条，有桑蚕丝（也称生丝）与柞蚕丝之分，统称为蚕丝。除去丝胶的蚕丝，叫做精炼丝。以它们为原料，就可用织机加工成各类品种的织物了。
30	30（三十）是29与31之间的自然数、正整数，是一个偶数，也是一个有理数。30=2*3*5。
床头灯	床头灯是因它用于床头而得名，有固定式和可移动式两类。可满足躺靠在床头读书报用光的需要。可以说是现代家庭卧室中的一颗“夜明珠”。在家居中，卧室是个让人摆脱劳累、休整身心、养精蓄锐的空间。因此，卧室里的光环境应该以温馨、惬意为追求目的。配置合宜的床头灯，往往在卧室照明中最为出彩。
60	60（六十）是59与61之间的自然数，同时也是偶数、合数、半完全数、过剩数、高合成数。
超火	应用介绍超火是江苏触网信息技术有限公司开发的一款社群工具APP，以社群为主，以直播互动、聊天交友为辅，为用户提供一个相互认识、互相交流、相互学习的平台，分享自己的成果，为用户提供更多社群营销思路。应用功能社群社交超火APP支持语音、图片、文字、视频等多种内容承载形式自由选择，群主可增设提问环节，挑选作答，提高群成员积极性，增强社群黏性，助力社群传播、管理、变现。社群直播直播+模式，直播观看量。社群电商覆盖需求、流量、信任、价值、成交、裂变，构建用户价值生态闭环。 需求：评估用户需求，挖掘用户痛点，设计变现产品和道具 流量：线上线下圈粉，用福利抽奖引流到超火社群 信任：社群运营、抽奖、直播互动打造信任 价值：利用超火完善的社群功能传播知识或技能，输出价值 成交：使用成交文案，限时限量，风险逆转等方式社群变现 裂变：培养铁杆、分名分利，传播裂变更新内容优化商城有卖商品 优化发送图片清晰度 修复
绑带	绑带，读音为bǎng dài ，汉语词语，意思是指包扎伤口的绷带。
墙壁	墻壁，指院子或房屋的四围。多以砖石等砌成，垂直于地面；比喻赖以依靠的人或力量。
洗澡	洗澡，能清除汗垢油污、消除疲劳、舒筋活血、改善睡眠、提高皮肤新陈代谢功能和抗病力。而且通过温水的浸泡，能够治疗某些疾病。热水澡水温不宜太高，一般以35～40℃的温水为宜。洗的次数也不宜太多，因为次数太多会把皮肤表面正常分泌的油脂及正常寄生在皮肤表面的保护性菌群全部洗掉，容易引起皮肤瘙痒等症，皮肤的抵抗力也会因此而减弱，反而容易得病。洗澡分淋浴和盆浴以及缸浴。
度假	度假旅游是利用假日外出以度假和休闲为主要目的和内容的，进行令精神和身体放松的康体休闲方式。
一体机	一体机，分为有影印一体机和电脑一体机。OfficeMate办公伙伴影印一体机简单而言就是集传真、打印与复印等功能为一体的机器。电脑一体机即一体台式机，是指将传统分体台式机的主机集成到显示器中，从而形成一体台式机。一体机的工作原理与传统油印机相似，均是通相同的图像），将图像印于纸上。但其蜡纸并非传过油墨穿过蜡纸上的细微小孔（小孔组成了与原稿统油印机上用的蜡纸或扫描蜡纸，而是热敏蜡纸，由一层非常薄的胶片和棉脂合成的。因此，在这些胶片上制作非常细小的孔，这使得它能印出非常精细的高质量印刷品。
夹棉	百度百科是一部内容开放、自由的网络百科全书，旨在创造一个涵盖所有领域知识，服务所有互联网用户的中文知识性百科全书。在这里你可以参与词条编辑，分享贡献你的
唐装	唐装是中国的一种服饰，指唐制汉服，为汉族服饰系统中一种款式，特征是交领、右衽、系带。代表有齐胸襦裙、唐圆领袍、交领襦裙等。唐装中的妇女上衣种类一般分为襦，袄，衫三种。襦是一种衣身狭窄短小的夹衣或棉衣。袄长于襦而短于袍，衣身较宽松，也有夹衣或棉衣。襦、袄有窄袖与长袖两类。汉服是中国“衣冠上国”、“礼仪之邦”、“锦绣中华”、赛里斯国的体现，承载了中华民族的染织绣等杰出工艺和美学，传承了30多项中国非物质文化遗产以及受保护的
钟表	钟表是一种计时的装置，也是计量和指示时间的精密仪器。 钟表通常是以内机的大小来区别的。按国际惯例，机心直径超过80毫米、厚度超过30毫米的为钟；直径37～50毫米、厚度4～6毫米者，称为怀表；直径37毫米以下为手表；直径不大于20毫米或机心面积不大于314平方毫米的，称为女表。手表是人类所发明的最小、最坚固、最精密的机械之一。
拖把	拖把，又称墩地抹布，指擦洗地面的长柄清洁工具，亦泛指长柄清洁工具。拖把应源于抹布。最传统的拖把，将一束布条捆扎在一个长木杆的一端就成了。简单，价廉。工作头由抹布块变成了一束布条，具有较强的去污能力。
植物	植物是生命的主要形态之一，包含了如树木、灌木、藤类、青草、蕨类、及绿藻、地衣等熟悉的生物。种子植物、苔藓植物、蕨类植物和裸子植物等植物中，据估计现存大约有350 000个物种。绿色植物大部分的能源是经由光合作用从太阳光中得到的，温度、湿度、光线、淡水是植物生存的基本需求。种子植物共有六大器官：根、茎、叶、花、果实、种子。绿色植物具有光合作用的能力——借助光能及叶绿素，在酶的催化作业下，利用
原木	原木是原条长向按尺寸、形状、质量的标准规定或特殊规定截成一定长度的木段，这个木段称为原木。原条经造材后形成的圆木段。有带皮的也有剥皮的。按原木材质和使用价值分为经济用材和薪炭材两大类。经济用材根据其使用情况又分直接使用原木和加工用原木。直接使用原木又分为采掘坑木、房建檩条等。加工用原木还可分特级原木、针叶树加工用原木和阔叶树加工用原木。这些原木作为森工主产品要符合国家木材标准。在标准中对每一种原木规定有树种、用途、尺寸及尺寸进级、公差、木材缺陷限度、尺寸检量及材质评定办法等。原木按长度一般可分为长原木(6米以上)、中长原木(3～5.8米)和短原木(2～2.8米);按直径一般可分为粗径木(60厘米以上)、大径木(40～58厘米)、中径木(30～38厘米)、小径木(20～28厘米)和细径木(18厘米以下);按材质分特级原木、一等原木、二等原木、三等原木和等外原木。原木等级根据原木自身缺陷(节子
宠物	以前宠物只是单指人们为了消除孤寂或出于娱乐目的而豢养的动物。现今宠物定义为，出于非经济目的而豢养的动植物。宠物是为了精神的目的而豢养的动植物。一般为了消除孤寂，或娱乐而豢养，以前的宠物一般是哺乳纲或鸟纲的动物，因为这些动物脑子比较发达，容易和人交流。如今，除了广为人知的活体宠物外，还有诸多的虚拟宠物。在所有动物类宠物中，普遍流行的主要为狗和猫，另外有鸟、鱼、虫、仓鼠、土拨鼠、刺猬、兔子等较为广泛。2019年7月，一项鼻纹识别解决方案推出，并已最先应用于犬只身份认证。这一方案将有助于城市中的宠物管理，使AI寻宠、宠物门禁、在线犬证办理等成为可能。
旋转	旋转（xuán zhuǎn），基本解释：物体围绕一个点或一个轴做圆周运动。如地球绕地轴旋转，同时也围绕太阳旋转。（《新华字典》（第11版）及《现代汉语词典》（第7版）读音均为xuánzhuǎn；但天旋地转的转为zhuàn无争议。）数学中，旋转是图形运动的一种。
耳钉	耳钉是耳朵上的一种饰物 ，比耳环小，形如钉状。一般需要穿过耳洞才能戴上，耳钉造型千变万化，但改变不了它这样的特点，耳垂前边是耳钉造型，耳垂后边是耳背（也有称之为耳堵）。通常有银质，金质，塑料材质等等类型．耳钉不佩戴的时候，或者佩戴之前，最好放入酒精里浸泡5分钟即可。有些人因为敏感会对一些金属产生过敏反应，建议如果过敏，最好使用银质的耳钉。
防漏	百度百科是一部内容开放、自由的网络百科全书，旨在创造一个涵盖所有领域知识，服务所有互联网用户的中文知识性百科全书。在这里你可以参与词条编辑，分享贡献你的
汤锅	汤锅，指屠宰场用的煺毛的大锅；也指屠宰场。
24	《24小时》是由美国Fox Film Corporation制作推出的一部动作枪战类惊悚片，由斯蒂芬·霍普金斯，强·卡萨，布拉德·特纳执导，基弗·萨瑟兰、卡洛斯·博纳德、伊丽莎·库斯伯特、丹尼斯·海斯伯特、莱斯利·霍普、玛丽·莱恩·莱杰斯库等主演。该剧每季24集，讲述一天内美国反恐小组CTU进行的一系列反恐行动，主人公杰克·鲍尔在24小时内如何在家庭、国家、平民之间进行抉择，最终打败恐怖分子的故事。该剧 2001年11月06日首播。
套头毛衣	百度百科是一部内容开放、自由的网络百科全书，旨在创造一个涵盖所有领域知识，服务所有互联网用户的中文知识性百科全书。在这里你可以参与词条编辑，分享贡献你的
彩色	彩色（Colours），指除消色以外的各种颜色，各有不同的色调、亮度和饱和度。彩色，可分为无彩色和有彩色两大类。前者如黑、白、灰，后者如红、黄、蓝等七彩。有彩色就是具备光谱上的某种或某些色相，统称为彩调。与此反，无彩色就没有彩调。无彩色有明有暗，表现为白、黑，也称色调。有彩色表现很复杂，但可以用三组特微值来确定。其一是彩调，也就是色相；其二是明暗，也就是明度；其三是色强，也就是纯度、彩度。明度、彩度确定色彩的状态。称为色彩的三属性。明度和色相合并为二线的色状态，称为色调。彩色是一个完全主观的认知经验，就如味觉、嗅觉一般。
超大	超级大本营（超级大本营军事论坛）简称“超大”，最具影响力中文军事论坛之一，国防建设、爱国主义科普教育基地，成立于2002年12月。
头戴式	百度百科是一部内容开放、自由的网络百科全书，旨在创造一个涵盖所有领域知识，服务所有互联网用户的中文知识性百科全书。在这里你可以参与词条编辑，分享贡献你的
ulzzang	Ulzzang，即eol-zzang，eol在韩语中是“脸蛋”（eol-gul）的第一个音，zzang为网络用语，有“第一”，“最好”的意思，所以ulzzang一词用来指代脸蛋最漂亮的人。ulzzang就是eol-zzang的意思。现在，ulzzang多指由网络评选出来具有高人气的帅哥美女们。在韩国，将很多长得漂亮身材又好的男人女人们，归称为ulzzang。很多ulzzang会把自己的照片、视频传到网上，并通过个人主页，UCC等网络媒体的广泛传播而获得不少人气，他们的大量照片被流传到中国。现今网络上频繁出现的“ulzzang”其实在韩国是表示有漂亮脸蛋的人。是韩国大众拥有漂亮脸蛋的人竞选的地方。被选拔出来的人将拥有自己的粉丝追捧者。和将要成为明星的可能。而今的ulzzang成了韩国时尚、潮流、美丽的代言词。
碎花	《碎花》是潘仪君演唱的一首歌曲，由刑增华填词，季伟松、李德松谱曲。收录在1994年7月1日发行唱片《你给我一片天》专辑中。
全包	全包是装修方式中的一种，全包和半包相比，装修方在装修中会负责购买更多的建材。
玩偶	玩偶的拼音为wán ǒu，指供儿童玩耍的人形玩具。语出巴金《利娜》上篇：“我和那些最时髦的小姐完全一样，又可以说完全像一个 巴黎制造的玩偶。”
贴纸	贴纸属于粘贴型的背干胶纸，是将各种图画、相片印刷在背干胶纸上，就是现在市面常见的贴纸，也是大众化的青少年和青年酷爱的一种时尚产品，可以粘贴在文具、杯碗、家具、电器、金属器、瓷器、机动车辆或非机动车辆、手机、笔记本、游戏机以及广告商标、工业指示标等等多元素系列的产品，使用范围非常之广，也是印刷产业的一大重点产品。它还印有各色的卡通人物等图案。可任意粘贴，大多数是一次性的。品种较多。
珊瑚	珊瑚，出生于山城重庆，国家二级演员；中国人民解放军空军政治工作部文工团独唱演员，重庆市青联委员。1998年荣获中央电视台第八届“大红鹰”杯全国青年歌手电视大奖赛（专业组）通俗唱法三等奖；少数民族文艺汇演“最佳新人奖”和团体“金奖”；首届华语网络歌曲最受网民爱戴的女歌手奖；演唱的歌曲《摆手舞》，荣获中宣部“五个一”工程奖。从2007年开始陆续推出红色经典《新音乐长征路》系列专辑；2015年出演原创音乐剧《嘎丽娅》；2016重庆“音爱无限”大型公益演唱会；
碗碟	百度百科是一部内容开放、自由的网络百科全书，旨在创造一个涵盖所有领域知识，服务所有互联网用户的中文知识性百科全书。在这里你可以参与词条编辑，分享贡献你的
禅意	禅意是一个汉语词汇，拼音是chán yì。犹禅心，指清空安宁的心。也做佛教术语。出自（唐） 刘长卿《寻南溪常山道人隐居》诗：“溪花与禅意，相对亦忘言。”
化妆品	根据2007年8月27日国家质检总局公布的《化妆品标识管理规定》，化妆品是指以涂抹、喷洒或者其他类似方法，散布于人体表面的任何部位，如皮肤、毛发、指趾甲、唇齿等，以达到清洁、保养、美容、修饰和改变外观，或者修正人体气味，保持良好状态为目的的化学工业品或精细化工产品。
居家	居家指所有和家庭生活相关的物品。包括家具，饰品，生活用品。现代的居家生活已不仅仅是局限在字面上的意思，居家更多的是现代人追求闲散，休闲，享受的一种生活方式。
托盘	托盘是使静态货物转变为动态货物的媒介物，一种载货平台，而且是活动的平台，或者说是可移动的地面。即使放在地面上失去灵活性的货物，一经装上托盘便立即获得了活动性，成为灵活的流动货物，因为装在托盘上的货物，在任何时候都处于可以转入运动的准备状态中。这种以托盘为基本工具组成的动态装卸方法，就叫做托盘作业。
羊毛衫	1 羊毛衫本指用羊毛织制的针织衫，这也是一般老百姓认同的含义，而实际上“羊毛衫”现在已成为一类产品的代名词，即用来泛指“针织毛衫”或称“毛针织品”。 毛针织品指主要是用是以羊毛、羊绒、兔毛等动物毛纤维为主要原料纺成纱线后织成的织物，诸如兔毛衫、雪兰毛衫、羊仔毛衫、腈纶衫等等都是“羊毛衫”大家族。
电视	电视 (Television 、TV、 Video）指使用电子技术传送活动的图像画面和音频信号的设备，即电视接收机。也是重要的广播和视频通信工具。电视机最早由英国工程师约翰·洛吉·贝尔德在1925年发明。电视用电的方法即时传送活动的视觉图像。同电影相似，电视利用人眼的视觉残留效应显现一帧帧渐变的静止图像，形成视觉上的活动图像。电视系统发送端把景物的各个微细部分按亮度和色度转换为电信号后，顺序传送。在接收端按相应几何位置显现各微细部分的亮度和色度来重现整幅原始图像。科学技术的进步，是电视迅速普及的一个重要原因。各国电视信号扫描制式与频道宽带不完全相同，按国际无线电咨询委员会（CCIR）的建议用拉丁字母来区别。
精华	精华，指事物之最精粹、最优秀的部分。也有精神元气的含义。语出汉 刘向《九叹·惜贤》：“扬精华以炫燿兮，芳郁渥而纯美。”
牛肉	牛肉（拼音：niú ròu），指牛身上获得的肉，为常见的肉品之一。来源可以是奶牛、公牛、小母牛。牛的肌肉部分可以切成牛排、牛肉块或牛仔骨，也可以与其他的肉混合做成香肠或血肠。其他部位可食用的还有牛尾、牛肝、牛舌、牛百叶、牛胰腺、牛胸腺、牛心、牛脑、牛肾、牛鞭。牛肠也可以吃，不过常用来做香肠衣。牛骨可用做饲料。阉牛和小母牛肉质相似，但阉牛的脂肪更少。年纪大的母牛和公牛肉质粗硬，常用来做牛肉末。肉牛一般需要经过育肥，饲以谷物、膳食纤维、蛋白质、维生素和矿物质。牛肉是世界第三消耗肉品，约占肉制品市场的25%。落后于猪肉（38%）和家禽（30%）。美国、巴西和中国是世界消费牛肉前三的国家。按2009年人年消费来看，阿根廷以64.6千克排名第一，美国为42.1千克，欧洲为11.9千克。最大的牛肉出口国包括印度、巴西、澳大利亚和美国。牛肉制品对于巴拉圭、阿根廷、爱尔兰、墨西哥、新西兰、尼加拉瓜、乌拉圭
蓝色	蓝色，是一种颜色，它是红绿蓝光的三原色中的一员，在这三种原色中它的波长最短，为440～475n纳米，属于短波长。蓝色是永恒的象征，它的种类很繁多，每一种蓝色又代表着不同的政治或其他含义，另外以蓝色命名的音乐、书籍、明星也不乏其例。由于空气中灰尘对日光的瑞利散射，晴天的天空是蓝色的。由于水分子中的氢-氧键对约750纳米的光的吸收，大量的水集中在一起呈蓝色。有意思的是，由于氘-氧键吸收波长比较长的光（约950纳米），因此重水是无色的。蓝色的对比色是橙色。蓝色的互补色是黄色。蓝色的情侣色是红色。蓝色的邻近色是青色、品红。
修护	百度百科是一部内容开放、自由的网络百科全书，旨在创造一个涵盖所有领域知识，服务所有互联网用户的中文知识性百科全书。在这里你可以参与词条编辑，分享贡献你的
豆豆	豆豆，女，1970年生，高中文化程度。作者十七岁时因工作关系认识了一个好朋友李红英（此人的人生观、价值观及其人格、品德和思维方式都给作者产生了重要影响）。1990年，李到欧洲定居，此后李不断寄给豆豆大量的参考资料，每次回国都给作者讲述一些作者所陌生的社会生活。作者于1995年6月动笔创作长篇小说《背叛》，1997年8月完稿。《背叛》一书在杂志《啄木鸟》2000年1—4期连载。2000年作者为一名普通工人，有一个可以长相厮守的丈夫。2011年12月，又完成长篇政治小说《天幕红尘》，于2013年7月出售。
儿童房	儿童房是孩子的卧室、起居室和游戏空间，应增添有利于孩子观察、思考、游戏的成分。在孩子居室装饰品方面，要注意选择一些富有创意和教育意义的多功能产品。科学合理地装潢儿童居室，对于儿童健康成长，培养儿童独立生活能力，启迪他们的智慧具有重要的意义，因此在儿童房的设计与色调上，要特别注意安全性与合理的搭配原理。
毛孔	毛孔是指脱除毛根后皮或革的粒面上露出来的孔状结构。不同的动物皮具有不同的毛孔大小和特殊的排列，形成不同的粒面纹路。毛孔指的毛囊口，它是毛囊和皮脂腺的共同开口，具有特定的生理功能。毛孔除了是一般人最熟知“长出毛发的孔”，它还有许多重要功能，其中大家感受最深的就是能排泄皮脂腺的分泌物。
台湾	台湾（Taiwan），简称“台”，是中华人民共和国省级行政区，省会台北，位于中国大陆东南海域，东临太平洋，西隔台湾海峡与福建省相望，南界巴士海峡与菲律宾群岛相对。台湾省由中国第一大岛台湾岛和周围属岛以及澎湖列岛两大岛群，共80余个岛屿所组成，总面积3.6万平方公里。台湾省人口约2350万，超过70%集中在台湾岛西部的5大都会区，其中以台北市为中心的台北都会区最大。台湾是中国领土不可分割的一部分。台湾省主要的少数民族高山族在17世纪
微波炉	微波炉（microwave oven/microwave），顾名思义，就是一种用微波加热食品的现代化烹调灶具。微波是一种电磁波。微波炉由电源，磁控管，控制电路和烹调腔等部分组成。电源向磁控管提供大约4000伏高压，磁控管在电源激励下，连续产生微波，再经过波导系统，耦合到烹调腔内。在烹调腔的进口处附近，有一个可旋转的搅拌器，因为搅拌器是风扇状的金属，旋转起来以后对微波具有各个方向的反射，所以能够把微波能量均匀地分布在烹调腔内，从而加热食物。微波炉的功率范围一般为500～1000瓦。
全套	全套指全部有关的单元或设备、部件。
皮毛	皮毛是汉语词汇，拼音pí máo，出自《周礼·天官·兽人》。
透明	透明是一个汉语词汇，读音为tòu míng，是物质透过光线的性质或情况，形容透亮和明白。透明还有晓悟等意思。出自《二刻拍案惊奇》。
冬天	冬天，又称冬季。北半球一年当中最寒冷的季节，其他的为春、夏、秋。天文学上认为是从12月至2月，中国习惯指立冬到立春的三个月时间，也指农历“十、十一、十二”三个月。冬季是部分地区一年四季中的第四季，由于天气转冷（赤道地区除外），在很多地区都意味着沉寂和冷清。生物在寒冷来袭的时候会减少生命活动，很多植物会落叶，动物会休眠，有的称作冬眠。候鸟会飞到较为温暖的地方过冬。
件套	百度百科是一部内容开放、自由的网络百科全书，旨在创造一个涵盖所有领域知识，服务所有互联网用户的中文知识性百科全书。在这里你可以参与词条编辑，分享贡献你的
李宁	李宁，男，壮族，1963年3月10日出生于广西壮族自治区来宾市兴宾区南泗乡，祖籍广东省佛山市顺德区，曾祖父辈迁至广西谋生，中国著名男子体操运动员、奥运冠军，绰号“体操王子”。李宁毕业于北京大学法学院，获得法学士学位及北京大学光华管理学院EMBA。1982年12月22日，李宁在南斯拉夫萨格勒布举行的第6届世界杯体操比赛中，李宁一人夺得男子全部7枚金牌中的6枚，获单杠、自由体操、跳马、鞍马、吊环和全能6项冠军，创造了世界体操史上的神话，被誉为“体操王子”。1984年获第23届洛杉矶奥运会男子体操单项比赛中夺得男子自由体操、鞍马和吊环3项冠军，一举夺得三金两银一铜，接近中国代表团奖牌总数的1/5，成为该届奥运会中获奖牌最多的运动员。李宁创造了世界体操史上的神话，先后摘取十四项世界冠军，赢得一百多枚金牌。1988年宣布退役后，李宁以其姓名命名创立了“李宁”运动品牌。运动品牌涉足广泛，从生产运动服装
旗袍	旗袍，中国和世界华人女性的传统服装，被誉为中国国粹和女性国服。虽然其定义和产生的时间至今还存有诸多争议，但它仍然是中国悠久的服饰文化中最绚烂的现象和形式之一。旗袍形成于上个世纪20年代，有部分学者认为其源头可以追溯到先秦两汉时代的深衣，民国20年代之后成为最普遍的女子服装，由中华民国政府于1929年确定为国家礼服之一。50年代后，旗袍在大陆渐渐被冷落，尤其文革中被视为“封建糟粕”、“资产阶级情调”遭受批判。80年代之后随着传统文化在内地被重新重视，以及影视文化、时装表演、选美等带来的影响，旗袍不仅逐渐在大陆地区复兴，还遍及世界各个时尚之地。1984年，旗袍被国务院指定为女性外交人员礼服。从1990年北京亚运会起，历次大陆举行的奥运会、亚运会以及国际会议、博览会多选择旗袍作为礼仪服装。2011年5月23日，旗袍手工制作工艺成为国务院批准公布第三批国家级非物质文化遗产之一。2014年11月，在
电源	电源是将其它形式的能转换成电能的装置。电源自“磁生电”原理，由水力、风力、海潮、水坝水压差、太阳能等可再生能源，及烧煤炭、油渣等产生电力来源。常见的电源是干电池（直流电）与家用的110V-220V 交流电源。
腰带	用来束腰的带子，裤带。若是皮革的，俗语也称皮带。中国早期的服装多不用纽扣，只在衣襟处缝上几根小带，用以系结，这种小带的名称叫“衿”。
炒锅	炒锅是中国一种烹饪工具，为锅的一种，特征是顶部开口大，圆底，由于中国南方食物多以小炒为主，故炒锅设计成有手柄以方便抛炒。炒锅主要用作煎或炒食物，但也可以用作蒸、炖、炸等其他不同的烹饪方法。炒锅是中国及东南亚的主要煮食工具。
哈衣	哈衣，又称连身衣、连体衣、爬服，还没这个概念的，也是一种新式服装。棉质哈衣对宝宝的皮肤有很好的保护作用，睡觉时穿也可避免宝宝因踢被而使肚肚受凉，方便宝宝活动。
冰箱	冰箱是保持恒定低温的一种制冷设备，也是一种使食物或其他物品保持恒定低温冷态的民用产品。箱体内有压缩机、制冰机用以结冰的柜或箱，带有制冷装置的储藏箱。家用电冰箱的容积通常为20～500升。1910年世界上第一台压缩式制冷的家用电冰箱在美国问世。1925年瑞典丽都公司开发了家用吸收式冰箱。1927年美国通用电气公司研制出全封闭式电冰箱。1930年采用不同加热方式的空气冷却连续扩散吸收式电冰箱投放市场。1931年研制成功新型制冷剂氟利昂12。50年代后半期开始生产家用热电冰箱，中国从50年代开始生产电冰箱。
真空	道家哲学，指真无。朱熹说佛教的“空”借用了老子的“无”，诠释了佛教的“空”。所以：“疑得佛家初来中国，多是偷老子意去做经，如说空处是也”（卷126，P.3008）。具体来说，“如远、肇法师之徒，只是谈庄老，后来人亦多以庄老助禅”（卷126，P.3025），佛“初来只有《四十二章经》，至晋宋间乃谈义，皆是剽窃老庄，取列子为多”（卷126，P.3038）。晋宋时的佛教教义、慧远和僧肇等人的著作，以及后起的禅宗皆与老子及庄、列的学说血肉相连。
床头柜	床头柜（bedside cupboard ），床头柜分为侧柜和主柜，侧柜是设置在床头左右两侧的小柜子。主柜一般都是比床头侧柜高很多，一般都是四门至六门的铁皮柜。主要设置在卧室、宿舍、病房、旅馆等有床的房间内使用，供存物取物吃饭之用。侧柜标配的有上部隐形就餐盘、抽屉，下边柜子、可置物门、毛巾架、杂物挂钩、轮子等组件，是小型半封闭式单抽可移动式储物立柜。供生活起居存放生活物品之用。床头柜以塑钢、不锈钢、金属喷塑等材料。侧柜设计与现代常见的床边柜相仿。具有防潮防湿防水浸、抗冲击、不褪色抗老化、无缝防蟑螂、密闭防鼠、易清洁精巧、移动方便等特点。有助于物品的安放。贮藏于床头柜中的物品，大多为了适应生活起居需要和取用的物品，如药品等，床头柜上摆放的是增添温馨气氛的一些照片、小幅画、插花等。
洗衣	百度百科是一部内容开放、自由的网络百科全书，旨在创造一个涵盖所有领域知识，服务所有互联网用户的中文知识性百科全书。在这里你可以参与词条编辑，分享贡献你的
意大利	意大利共和国（意大利语：Repubblica Italiana），简称意大利（意大利语：Italia），是一个欧洲国家，主要由南欧的亚平宁半岛及两个位于地中海中的岛屿西西里岛与萨丁岛所组成。国土面积为301333平方公里，人口6080万。北方的阿尔卑斯山地区与法国、瑞士、奥地利以及斯洛文尼亚接壤，其领土还包围着两个微型国家——圣马力诺与梵蒂冈。意大利首都罗马，几个世纪一直都是西方文明的中心。古罗马先后经历
新茶	新茶，是指当年春季从茶树上采摘的头几批鲜叶加工而成的茶叶。为求其鲜嫩，一些茶农在清明节前就开始采茶，这样的茶被称为明前茶；谷雨节气前采的茶，被称为雨前茶。有些消费者以品新茶为乐，争相购买明前茶、雨前茶。其实，“茶叶越新鲜越好”的观点是一种误解。并不是所有的茶叶都是越新鲜越好，普洱茶、黑茶就是越陈越好，而追求新鲜的茶叶则为绿茶，但即使是绿茶也并非需要新鲜到现采现喝。
海宁	海宁，隶属于浙江省嘉兴市，位于中国长江三角洲南翼、浙江省北部，东邻海盐县，南濒钱塘江，与绍兴上虞区、杭州萧山区隔江相望，西接杭州余杭区、江干区下沙，北连桐乡市、嘉兴秀洲区。东距上海100公里，西接杭州，南濒钱塘江。1986年撤县设市。海宁之名，始见于南朝陈武帝永定二年（558），寓“海洪宁静”之意。其境内名胜“钱江涌潮”，自唐宋便已盛行，闻名国内外，“八月十八潮，壮观天下无”，至今仍吸引八方宾客，一睹涌潮奇景。海宁市历史绵长，各界名人辈出，是李善兰、王国维、
36	36是位于35和37之间的自然数、正整数；是一个阿拉伯数字，是一个偶数,合数，也是平方数，是6和-6的平方。
入耳式	百度百科是一部内容开放、自由的网络百科全书，旨在创造一个涵盖所有领域知识，服务所有互联网用户的中文知识性百科全书。在这里你可以参与词条编辑，分享贡献你的
高跟鞋	高跟鞋是一种鞋跟特别高的鞋，使穿此鞋人的脚跟明显比脚趾高。高跟鞋有许多种不同款式，尤其是在鞋跟的变化上更是非常多，如细跟、粗跟、楔型跟、钉型跟、槌型跟、刀型跟等。高跟鞋除了增加高度，更重要的因素是可以增进诱惑力。高跟鞋使女人步幅减小，因为重心后移，腿部就相应挺直，并造成臀部收缩、胸部前挺，使女人的站姿、走姿都富有风韵，袅娜与韵致的形象应运而生。
刻字	古时候人们用刀在木头或石头上雕刻出文字，而当今的人们能用多种方法在多种材料上雕刻各种字体，如：石材，木材，
抖音	抖音，是一款可以拍短视频的音乐创意短视频社交软件，该软件于2016年9月上线，是一个专注年轻人音乐短视频社区平台。用户可以通过这款软件选择歌曲，拍摄音乐短视频，形成自己的作品。2018年7月1日至7月31日，抖音平台累计清理36323条视频，8463个音频，252个挑战，永久封禁39361个账号，并被处以警告和罚款的行政处罚。
男中	百度百科是一部内容开放、自由的网络百科全书，旨在创造一个涵盖所有领域知识，服务所有互联网用户的中文知识性百科全书。在这里你可以参与词条编辑，分享贡献你的
柜子	拼音：guì zǐ，英文名：cabinet。释义：收藏衣物、文件、书籍等用的器具，方形或长方形，一般为木制或铁制。柜子是一种长方形家具或办公用品，形体较高大，可存放物品。柜子的使用始于夏商周时期，那时称为“椟”。到了明清时期，柜子成为室内必备的家具，且形制已定型。明清柜子按形制可分为方角柜、圆角柜、亮格柜，形制不同，其构成部件也有不同。柜类家具主要是指以木材、人造板或金属等材料制成的各种用途不同的柜子。
门厅	门厅为进门大厅，一般在进门的地方的缓冲区。作用为公共活动区较小，起过渡作用。门厅的布置应当根据实用功能来定，有的家庭把门厅当作会客室用，有的当作餐室来用，也有的把门厅当作贮物间或干脆只当个走廊用。人口多的家庭或大儿大女无法分开居住的，就把门厅作卧室，还有许多三口之家，也把一居室的门厅当作卧室来布置。无论怎样布置门厅，只要巧妙，都能取得很好的效果。
吸水	百度百科是一部内容开放、自由的网络百科全书，旨在创造一个涵盖所有领域知识，服务所有互联网用户的中文知识性百科全书。在这里你可以参与词条编辑，分享贡献你的
夹心	夹心是一个汉语词汇，意思是夹馅。
古典	古典：中国内地青年演员古典：天南星科花烛属红掌品种古典：汉语词语古典：新精英生涯创始人
女友	指在情侣关系中，男方对女方的称谓，即人们通常说的女朋友的简称。
登山	登山（mountaineering）：是指在特定要求下，运动员徒手或使用专门装备，从低海拔地形向高海拔山峰进行攀登的一项体育活动。登山运动可分为登山探险（也称高山探险）、竞技攀登（包括攀岩、攀冰等）和健身性登山。登山设备要适应登山运动的环境条件，在设计、选材、用料、制作上要尽量使其轻便、坚固、高效，并能一物多用。经常出外进行登山活动对人体有很大的好处，从医学角度来说，它对人的视力、心肺功能、四肢协调能力、体内多余脂肪的消耗、延缓人体衰老等五个方面有直接的益处。
轻奢	百度百科是一部内容开放、自由的网络百科全书，旨在创造一个涵盖所有领域知识，服务所有互联网用户的中文知识性百科全书。在这里你可以参与词条编辑，分享贡献你的
耳环	耳环又称耳坠，是古时候女子的饰物之一，常戴在耳朵的饰品。而在古代，耳环又称为珥、珰。在材料上，耳环都是金属为主，也有些可能是石头、木、或其他相似的硬物料。而现今，也有用塑料作为材料的耳环。虽说现代装扮开放，不管男女都可以佩戴耳环，但习惯于并喜欢佩戴耳环的现今还是女性比较多。
中筒	百度百科是一部内容开放、自由的网络百科全书，旨在创造一个涵盖所有领域知识，服务所有互联网用户的中文知识性百科全书。在这里你可以参与词条编辑，分享贡献你的
桌布	释义词目：桌布拼音：zhuō bù定义：桌布又称台布，英文名：tablecloth 为覆盖于台面、桌面上用以防污或增加美观的物品。基本解释[tablecloth] 布、塑料制品或其他织物制成的桌面美化或保护性片状物详细解释铺在桌面上做装饰或保护用的布或类似布的片状物。茅盾《创造》：“靠着南窗的小书桌，铺了墨绿色的桌布。”
饭盒	饭盒是一种专门用来装饭菜的盒子，也称便当盒，大多用铝、不锈钢、塑料制成。 出处：杨朔 《三千里江山》第五段：“饭盒里的饭咕嘟咕嘟响。”饭盒包括塑料饭盒、保温饭盒、普通饭盒。保温饭盒是在普通的饭盒外加设了保温外壳，有内外两层中充填泡沫塑料，再在内层镀以金属薄膜构成。从传导、辐射、对流三个方面减少热量的损失。又在饭盒和外壳之间加装一电加热装置，补充热量的损失，使饭菜保持在一定的较高温度。
牛排	牛排，或称牛扒，是块状的牛肉，是西餐中最常见的食物之一。牛排的烹调方法以煎和烧烤为主。欧洲中世纪时，猪肉及羊肉是平民百姓的食用肉，牛肉则是王公贵族们的高级肉品，尊贵的牛肉被他们搭配上了当时也是享有尊贵身份的胡椒及香辛料一起烹调，并在特殊场合中供应，以彰显主人的尊贵身份。清末小说中已出现「牛排」、「猪排」等西菜菜名，可能是因形似上海「大排」（猪丁骨），故名「排」。而在上海话里，「排」发[ba]音，广东又作牛扒。
充电式	百度百科是一部内容开放、自由的网络百科全书，旨在创造一个涵盖所有领域知识，服务所有互联网用户的中文知识性百科全书。在这里你可以参与词条编辑，分享贡献你的
网纱	筛网分为金属网和化纤网，其名称叫法有筛网、网纱、丝网等，规格繁多，用途广泛。
乳液	乳液是一种液态霜类护肤品，因为看起来纯白如牛奶，所以叫乳液。乳液具有良好的润肤作用，也有保湿效果，特别适合干燥的春，秋两季使用，如果肌肤是中性，也可以冬季使用。春秋两季使用时，除了润肤保湿效果外，还可以隔离外界干燥的气候，防止肌肤水分流失过快，避免肌肤干裂，起皮，是干燥季节外出时必用的护肤品。
户外运动	户外运动，是一组在自然环境举行的带有探险或体验探险的运动项目群。其中包括登山、攀岩、悬崖速降、皮划艇、潜水、帆船、定向运动、等项目，户外运动中多数带有探险性，属于极限和亚极限运动，有很大的挑战性和刺激性，拥抱自然，挑战自我。
胸罩	胸罩（Brassiere）是女性使用的内衣之一，又称奶头布、乳罩、乳房罩，奶罩或文胸等，功能是用以遮蔽及支撑乳房。“胸罩”一词据说第一次出现在1907年，那年美国版的时尚杂志《VOUGE》印有这个"bra"字眼，"bra"（胸罩）这个词并于1911年被正式载入牛津词典。胸罩起源说法不一，但多认为源自法国，称之为“Brassière”（简称为“Bra”）。中世纪的欧洲贵族流行穿一种非常紧身的束衣，后来因束衣太麻烦，改用两条手帕制成胸衣，成为了现代胸罩的雏型。
袜子	一种穿在脚上的服饰用品。《说文》：“韤，足衣也。”起着保护脚和防脚臭的作用。袜子是总称，按原料分有棉纱袜、毛袜、丝袜和各类化纤袜等，按造型上有长筒袜、中筒袜、船袜等，还有平口、罗口，有跟、无跟和提花、织花等多种式样和品种。
高端	1、属性词。指的是等级、档次、价位等在同类中较高的：高端技术、高端产品；2、是名词，指高层官员或负责人：高端会议、高端访问。
毛巾	毛巾是一种清洁用品，特征为方形纯棉纺织品，使用方法为打湿后拧干擦拭皮肤，以达到去除污渍、清洁凉爽的效果。毛巾是由三个系统纱线相互交织而成的具有毛圈结构的织物。这三个系统的纱线即是毛经、地经和纬纱。随着科技的发展，又出现了经编毛巾织物，这种毛巾毛圈固结牢，但形式相对单一，市场上的绝大部分为机织毛巾。世界上第一条毛巾诞生于1850年，产地英国，距今已有160多年的历史。由当初的最简单的单色平毛毛巾发展到现在的提缎提花、印花、无捻毛巾、割绒毛巾等，是发展时间最短而发展速度最快的纺织产品。
睡袋	睡袋就是睡觉时用的袋子。目前市场上绝大部分的睡袋都有舒适温度和极限温度的标识，舒适温度是使用者在整夜睡眠中的一系列温度，有最高和最低限度。最高舒适温度是指在睡袋中感到热但不是出大量汗水的那种热，一般定义情况为睡袋拉链打开，手臂放在外面，睡袋头部不收紧等。
耐克	NIKE公司总部位于美国俄勒冈州波特兰市。公司生产的体育用品包罗万象，例如服装，鞋类，运动器材等。NIKE是全球著名的体育运动品牌，英文原意指希腊胜利女神，中文译为耐克。耐克商标图案是个小钩子。耐克一直将激励全世界的每一位运动员并为其献上最好的产品视为光荣的任务。耐克首创的气垫技术给体育界带来了一场革命。运用这项技术制造出的运动鞋可以很好地保护运动员的膝盖.在其在作剧烈运动落地时减小对膝盖的影响。2016年6月8日，《2016年BrandZ全球最具价值品牌百强榜》公布，耐克排第24名。2016年9月8日，苹果牵手耐克正式推出第二代Apple Watch第二代产品。2017年3月15日，3·15晚会曝光，耐克Hyperdunk 08 FTB（SKU: 869611-001）篮球运动鞋被发现气垫描述不正确。4
蜂蜜	蜂蜜是蜜蜂从开花植物的花中采得的花蜜在蜂巢中经过充分酿造而成的天然甜物质。蜜蜂从植物的花中采取含水量约为75%的花蜜或分泌物，存入自己第二个胃中，在体内多种转化的作用下，经过15天左右反复酝酿各种维生素、矿物质和氨基酸丰富到一定的数值时，同时把花蜜中的多糖转变成人体可直接吸收的单糖葡萄糖、果糖，水分含量少于23%存贮到巢洞中，用蜂蜡密封。蜂蜜是糖的过饱和溶液，低温时会产生结晶，生成结晶的是葡萄糖，不产生结晶的部分主要是果糖。
棉质	百度百科是一部内容开放、自由的网络百科全书，旨在创造一个涵盖所有领域知识，服务所有互联网用户的中文知识性百科全书。在这里你可以参与词条编辑，分享贡献你的
经济型	百度百科是一部内容开放、自由的网络百科全书，旨在创造一个涵盖所有领域知识，服务所有互联网用户的中文知识性百科全书。在这里你可以参与词条编辑，分享贡献你的
加长	百度百科是一部内容开放、自由的网络百科全书，旨在创造一个涵盖所有领域知识，服务所有互联网用户的中文知识性百科全书。在这里你可以参与词条编辑，分享贡献你的
娃娃	金智娟（Wawa King），艺名娃娃，1964年10月4日出生于台湾高雄市冈山区，1981年和朋友组成丘丘合唱团，担任主唱。加盟新格唱片，1982年首张专辑《就在今夜》出版，同名歌曲及《为何梦见他》红遍大街小巷。娃娃从此被列为台湾摇滚女歌手第一人。
尿不湿	尿不湿是婴儿常用的日用品，是纸尿片、纸尿裤、拉拉裤的统称。干爽的尿不湿可以使婴儿保持整夜的安睡，由于吸水性强，被俗称为“尿不湿”。其中，高吸水性树脂（简称高分子SAP）是制造婴儿尿不湿的绝好材料，它是由淀粉和丙烯酸盐做主要原料制成的；突出特点是吸水和蓄水量大得惊人。
洗面奶	洗面奶属于洁肤化妆品，其目的是清除皮肤上的污垢，使皮肤清爽，有助于保持皮肤正常生理状态。洗面奶清洗皮肤时，清洗的对象物（即基质）是人体皮肤，粘附在上面的污垢基本是皮脂和角质层碎片及其氧化分解物（污垢），或者是与之黏在一起的美容化妆品残留物。这些残留代谢产物是不稳定的，可与空气中的氧，或沉积分子反应。在暴露于阳光时或皮肤上有细菌存在，会发生各种物理化学和生物化学反应，形成一些可能伤害皮肤的物质。因而，即使是健康皮肤，皮肤清洁也是皮肤护理所必需的过程。此外，对于敏感的，或脆弱的皮肤，由于其特性，更加需要特别清洁和护理。对于有问题皮肤类型，必须着重考虑洗面奶的温和性和安全性。
圣诞	圣诞节（Christmas）又称耶诞节，译名为“基督弥撒”，它源自古罗马人迎接新年的农神节，与基督教本无关系。在基督教盛行罗马帝国后，教廷随波逐流地将这种民俗节日纳入基督教体系，同时以庆祝耶稣的降生。但在圣诞节这天不是耶稣的生辰，因为《圣经》未有记载耶稣具体生于哪天，同样没提到过有此种节日，是基督教吸收了古罗马神话的结果。大部分的天主教教堂都会先在12月24日的平安夜，亦即12月25日凌晨举行子夜弥撒，而一些基督教会则会举行报佳音，然后在12月25日庆祝圣诞节；基督教的另一大分支——东正教的圣诞节庆则在每年的1月7日。圣诞节也是西方世界以及其他很多地区的公共假日，例如：在亚洲的中国香港和澳门地区、马来西亚、新加坡。 
筒裤	筒裤是汉语词汇，拼音是tǒng kù，意思是裤管上下部一样大小似直筒状。
摩托车	摩托车，由汽油机驱动，靠手把操纵前轮转向的两轮或三轮车，轻便灵活，行驶迅速，广泛用于巡逻、客货运输等，也用作体育运动器械。从大的方向上来说，摩托车分为街车，公路赛摩托车，越野摩托车，巡航车，旅行车等。
芝士	奶酪（cheese），又名干酪，是一种发酵的牛奶制品，其性质与常见的酸牛奶有相似之处，都是通过发酵过程来制作的，也都含有可以保健的乳酸菌，但是奶酪的浓度比酸奶更高，近似固体食物，营养价值也因此更加丰富。每公斤奶酪制品都是由10公斤的牛奶浓缩而成，含有丰富的蛋白质、钙、脂肪、磷和维生素等营养成分，是纯天然的食品。就工艺而言，奶酪是发酵的牛奶；就营养而言，奶酪是浓缩的牛奶。奶酪也是中国西北的蒙古族，哈萨克族等游牧民族的传统食品，在内蒙古称为奶豆腐，在新疆俗称乳饼，完全干透的干酪又叫奶疙瘩，世界出口奶酪最多的国家是荷兰。
沐浴露	沐浴露又称沐浴乳，是指洗澡时使用的一种液体清洗剂，是一种现代人常见的的清洁用品，沐浴乳的发明主要是为了取代传统清洁肥皂的触感和功效。沐浴乳接触人们肌肤时并不会有像肥皂那样硬梆梆的感觉，氨基酸沐浴液的效果格外明显，氨基酸沐浴露相较硫酸盐类表面活性剂为原料的沐浴露PH值偏低些，温和滋润肌肤，不会对皮肤造成强酸碱刺激。
狗狗	狗（拉丁文Canis lupus familiaris）属于脊索动物门、脊椎动物亚门、哺乳纲、真兽亚纲、食肉目、裂脚亚目、犬科动物。中文亦称“犬”，狗分布于世界各地。狗与马、牛、羊、猪、鸡并称“六畜”。有科学家认为狗是由早期人类从灰狼驯化而来，驯养时间在4万年前~1.5万年前。被称为“人类最忠实的朋友”，是饲养率最高的宠物，其寿命大约在12~18年。在中国文化中，狗属于十二生肖之一，在十二生肖中的第11位。
沙发垫	沙发垫是指直接铺在沙发上坐面上的垫子，主要用途是用来包裹保护沙发。沙发本身很容易落灰弄脏，加上人为破坏，短时间就会变得很脏，清洗起来非常不方便，沙发垫解决了这个问题。沙发垫还很方便的辅佐在沙发上，多余的可以塞到沙发缝里，可以更加固定沙发的垫子，在沙发上更加不容易滑动。
笔记本电脑	笔记本电脑（NoteBook Computer，简称为：NoteBook），亦称笔记型、手提或膝上电脑（英语：Laptop Computer，简称为Laptop），是一种小型、可方便携带的个人电脑。笔记本电脑的重量通常重1－3千克。其发展趋势是体积越来越小，重量越来越轻，而功能却越来越强大。像Netbook，也就是俗称的上网本。笔记本电脑跟PC的主要区别在于其便携带性。
凳子	在坐具当中，家具凳子，马扎是最早出现的，它是凳子的前身，在凳子上加一个靠背就衍变成为了椅子。凳子在民间的称谓叫杌凳。最初用来踩踏上马、上轿时使用，所以也称马凳、轿凳。民间俗称的名字中，还有“武凳”，因为习武之人坐如钟，不需要倚靠什么，因此得名。凳子的用料简单，用途广泛，所以比椅子流传的数量大。凳子的形状很丰富，出现的早期是长方形，一直延续到明代，到了清代变成了方形，还出现了圆形、扇面形、梅花形、六角形的凳子等。
15	《15》是方大同于2011年4月21日发行的专辑，共收录了《昙花》、《二人游》等12首歌曲。该专辑的词曲、编曲均由方大同创作。2011年12月29日，该专辑获得2011年度香港新城劲爆专辑奖；2012年1月1日，该专辑获得2011年度叱咤乐坛至尊唱片大奖。
乳胶	乳胶(latex)泛指聚合物微粒分散于水中形成的胶体乳液。又称胶乳。习惯上将橡胶微粒的水分散体称为胶乳，而将树脂微粒的水分散体称为乳液。以乳胶为原料制成的制品称乳胶制品，常见的如海绵、手套、玩具、胶管等。
紫砂	紫砂是一种介于陶器与瓷器之间的陶瓷制品，其特点是结构致密，接近瓷化，强度较大，颗粒细小， 断口为贝壳状或石状，但不具有瓷胎的半透明性。宜兴紫砂器胎质具有这种特性，而且，于器表光挺平整之中，含有小颗粒状的变化，表现出一种砂质效果。紫砂器的泥色有多种，俗称“五色土”，除去主要“五色”的朱泥、紫泥、段泥、黑泥、墨绿泥外，尚有白泥、乌泥、黄泥、松花泥等各种色泽，紫砂器不挂釉，而是充分利用泥本色，烧成后色泽温润，古雅可爱，紫砂器面还具有亚光效果，既可减弱光能的反射，又能清晰地表现器物形态、装饰与自身天然色泽的生动效果。紫砂陶质地古朴纯厚，不媚不俗，与文人气质十分相似，以至文人深爱笃好、以坯当纸，或撰壶铭，或书款识，或刻以花卉，刻以印章，托物寓意，每见巧思。2018年12月，教育部办公厅关于公布南京大学为紫砂中华优秀传统文化传承基地。
燃气灶	燃气灶是指以液化石油气（液态）、人工煤气、天然气等气体燃料进行直火加热的厨房用具。燃气灶又叫炉盘，其大众化程度无人不知，但又很难见到一个通行的概念。按气源讲，燃气灶主要分为液化气灶、煤气灶、天然气灶。按灶眼讲，分为单灶、双灶和多眼灶。
阔腿	百度百科是一部内容开放、自由的网络百科全书，旨在创造一个涵盖所有领域知识，服务所有互联网用户的中文知识性百科全书。在这里你可以参与词条编辑，分享贡献你的
茶道	茶道，就是品赏茶的美感之道。亦被视为一种烹茶饮茶的生活艺术，一种以茶为媒的生活礼仪，一种以茶修身的生活方式。它通过沏茶、赏茶、闻茶、饮茶、增进友谊，美心修德，学习礼法，领略传统美德，是很有益的一种和美仪式。喝茶能静心、静神，有助于陶冶情操、去除杂念。茶道精神是茶文化的核心。茶道被誉为是道家的化身。茶道文化起源于中国，南宋时期传入日本和朝鲜，元朝以后在中国衰落。现如今，茶道文化已在日本流行。
金丝绒	金丝绒是一种纺织品，以蚕丝和粘胶长丝为原料交织，地组织为平纹，用双层织造的经起绒丝织物。绒面绒毛浓密，毛长且略有倾斜，但不及其他绒类平整。一般用于潮流休闲女装、帷幕和装饰用品。
大功率	百度百科是一部内容开放、自由的网络百科全书，旨在创造一个涵盖所有领域知识，服务所有互联网用户的中文知识性百科全书。在这里你可以参与词条编辑，分享贡献你的
灯芯绒	灯芯绒是割纬起绒、表面形成纵向绒条的棉织物。因绒条像一条条灯草芯，所以称为灯芯绒。灯芯绒质地厚实，保暖性好，适宜制作秋冬季外衣、鞋帽面料和幕布、窗帘、沙发面料等装饰用品。采用纬二重组织织制、再经割绒整理，布面呈灯芯状绒条的织物，又称条绒布。
口味	《考古》1972年第5期引 满城 汉 墓出土错金银鸟虫书铜壶腹铭：“口味充闾，益肤，延寿谷病，万年有馀。”《北史·宇文述传》：“ 述 时贵重，委任与 威 等，其亲爱则过之。帝所得远方贡献及四时口味，辄见班赐。”《隋书·高祖纪上》：“丁亥，诏犬马器玩口味不得献上。” 元 无名氏 《黄鹤楼》第三折：“听知的元帅在此筵宴，小的每无甚么孝顺，将着这一对金色鲤鱼，元帅跟前献口味来。”
升降	升降，指登高与趋下的意思，上前与后退升或进与黜退。
脚垫	脚垫主要是由于角质层老化，脚部经络血液循环不畅、皮肤长期受挤压或摩擦皮下水分与功能失衡而导致的角质增生物。主要发病部位为前脚掌和脚趾的下方。脚垫会造成脚掌刺痛感。长时间的脚垫会影响足部经络的血液循环，对身体健康造成危害。
挂衣架	百度百科是一部内容开放、自由的网络百科全书，旨在创造一个涵盖所有领域知识，服务所有互联网用户的中文知识性百科全书。在这里你可以参与词条编辑，分享贡献你的
平角	一条射线绕它的端点旋转，当始边和终边在同一条直线上，方向相反时，所构成的角叫平角。1平角=180°+360°k(k∈Z) 平角不是一条直线，而是在一条直线上的两条射线。 应该这样理解： 任何“角”都是由两条有公共顶点的射线形成的，平角也不例外。 只不过形成平角的两条射线在一条直线上而已。 确切地说，平角是由处在同一直线上方向相反的两条射线构成的角，不能将直线和射线混为一谈 ，根据角的定义:角是具有公共顶点的两条射线组成的图形。即平角是一个点向相反的两个方向作射线,不能简单看作一条直线. 角的定义：角是具有公共顶点的两条射线组成的图形。 平角既然是角，它就应符合角的定义，也就是说，它也是由两条射线组成，只不过这两条射线的方向刚好相反。实际上它仍然不是一条直线。 因为平角也有顶点，和其他角一样。平角是由一点引出的两条射线组成的。
收口	收口，指编织物开口处收拢起来；伤口愈合。见元 无名氏 《气英布》第三折：“俺汉王本为足上箭疮未曾收口，要洗的乾浄。”
七分	百度百科是一部内容开放、自由的网络百科全书，旨在创造一个涵盖所有领域知识，服务所有互联网用户的中文知识性百科全书。在这里你可以参与词条编辑，分享贡献你的
夜光	夜光是一个词语，读音为yè guāng，指夜晚某些大自然物体发光，包含星月之光、萤火虫、夜明珠、荧光粉等物体的闪光现象。
按摩	按摩是以中医的脏腑、经络学说为理论基础，并结合西医的解剖和病理诊断，而用手法作用于人体体表的特定部位以调节机体生理、病理状况，达到理疗目的的方法，从性质上来说，它是一种物理的治疗方法。从按摩的治疗上，可分为保健按摩、运动按摩和医疗按摩。
立式	立式，读音是lìshì，汉语词汇，解释为直立的、竖直的。
束脚裤	百度百科是一部内容开放、自由的网络百科全书，旨在创造一个涵盖所有领域知识，服务所有互联网用户的中文知识性百科全书。在这里你可以参与词条编辑，分享贡献你的
适用	适用指的是符合客观条件的要求，适合应用。示例：这个新的种植法对我们这个地区很适用。
速溶	《速溶》作者轱辘，中国文史出版社出版。
汤碗	6英寸汤碗
充电器	充电器是采用高频电源技术，运用先进的智能动态调整充电技术。工频机是以传统的模拟电路原理来设计的，机器内部电力器件（如变压器、电感、电容器等）都比较大，一般在带载较大运行时存在较小噪声，但该机型在恶劣的电网环境条件中耐抗性能较强，可靠性及稳定性均比高频机强。
西餐	西餐，顾名思义是西方国家的餐食。西方国家，是相对于东亚而言的欧洲白人世界文化圈，西餐的准确称呼应为欧洲美食，或欧式餐饮。其菜式料理与中国菜不同，一般使用橄榄油、黄油、番茄酱、沙拉酱等调味料。不同的主食相同的都是搭配上一些蔬菜，如番茄、西兰花等。西餐这个词是由于其特定的地理位置所决定的。“西”是西方的意思。一般指欧洲各国。“餐”就是饮食菜肴。东方人通常所说的西餐主要包括西欧国家的饮食菜肴，当然同时还包括东欧各国，地中海沿岸等国和一些拉丁美洲如墨西哥等国的菜肴。而东南亚各国的菜肴一般统称为东南亚菜，但也有独为一种菜系的，如印度菜。西餐一般以刀叉为餐具以面包为主食，多以长形桌台为台形。西餐的主要特点是主料突出，形色美观，口味鲜美，营养丰富，供应方便等。正规西菜而言应包括了餐汤、前菜、主菜、餐后甜品及饮品。西餐大致可分为法式、英式、意式、俄式、美式，地中海等多种不同风格的菜肴。
logo	LOGO是徽标或者商标的外语缩写，是LOGOtype的缩写，起到对徽标拥有公司的识别和推广的作用，通过形象的徽标可以让消费者记住公司主体和品牌文化。网络中的徽标主要是各个网站用来与其它网站链接的图形标志，代表一个网站或网站的一个板块。另外，LOGO还是一种早期的计算机编程语言，也是一种与自然语言非常接近的编程语言，它通过“绘图”的方式来学习编程，对初学者特别是儿童进行寓教于乐的教学方式。
100g	百度百科是一部内容开放、自由的网络百科全书，旨在创造一个涵盖所有领域知识，服务所有互联网用户的中文知识性百科全书。在这里你可以参与词条编辑，分享贡献你的
学生宿舍	2017年12月1日，《公共服务领域英文译写规范》正式实施，规定学生宿舍标准英文名为Student Dormitory。1 
编织	编织：汉语词汇编织：谭咏麟演唱歌曲编织：手工艺术语编织：Dota中暗影牧师的技能
泡面	方便面，又称快餐面、泡面、杯面、快熟面、速食面、即食面，南方一般称为碗面，香港则称之为公仔面，是一种可在短时间之内用热水泡熟食用的面制食品。广义上是指一种可在短时间之内用热水泡熟食用的面制食品，有相关的菜肴如归泡面、泡面沙拉等；狭义的方便面上通常指由面饼、调料包及油包组成的销售成品，市面上以袋装和杯或碗装居多。安藤百福在1958年发明方便面，随着生活节奏加快及旅行需要，方便面为现代生活不可或缺的简易食品之一。方便面是通过对切丝出来的面条进行蒸煮、油炸，让面条形状固定（一般为方形或圆形），食用前以开水冲泡，溶解调味料，并将面条加热冲泡开，在短时间（一般在3分钟内）内便可食用的即食方便食品。如今市场上各种品牌的方便面充斥着各大商场的货架，从大型零售超市到街头的小门头商铺都能够看到它的身影。
纯银	纯银，即为含量接近100%的金属银。银化学性质不活泼，但由于银与硫有特殊的亲和性，在空气中即能缓慢的生成硫化银而使其变黑，使银不纯。而且在自然界中银易与铂等金属混合，故生活中的“纯银”一般指含量99.99%的白银或者含量92.5%的925纯银。
衣架	衣架是用来搭披衣衫的架子。《鲁班经匠镜》讲到有素衣架和花衣架两种，外间较为少见。当时的衣架与现在的衣架不同。现代衣架大多采用挂钩式或枝叉式，衣物多以脖领处挂在衣钩上。古人衣架，包括清代衣架，多采用横杆形式，两侧有立柱，上下承木墩底座，两座之间有横板或横枨，立柱顶端安横梁，两端长出立柱，尽端雕出龙凤纹或灵芝或云头之类。横杆之下安中牌子，上有透雕装饰，主要起牢固作用。衣服脱下后就搭在横杆之上。此外，还有同名的电影。
饭碗	饭碗，盛饭用的碗。常用陶瓷、金属、无毒塑料、木材等制作，在现代激烈的市场竞争中，经常比喻为职业、生意、市场等。
外出	《外出》是一部由许秦豪执导，裴勇俊、孙艺珍领衔主演的韩国爱情电影。该片于2005年9月7日在韩国上映。影片讲述了舒英的丈夫不幸遭遇车祸成为植物人，她却与车祸当时跟丈夫一起搭车的女人的丈夫仁书邂逅。面对背叛爱情的两个人，渐渐发展成复杂的关系的故事。
普洱茶	普洱茶（学名：Camellia sinensis var. assamica），大乔木，高达16米，嫩枝有微毛，顶芽有白柔毛。叶薄革质，椭圆形，上面干后褐绿色，略有光泽，下面浅绿色，中肋上有柔毛，其余被短柔毛，老叶变秃；侧脉8-9对，在上面明显。花腋生，被柔毛。苞片2，早落。萼片5，近圆形，外面无毛。花瓣6-7片，倒卵形，无毛。雄蕊长8-10毫米，离生，无毛。子房3室，被茸毛；花柱长8毫米，先端3裂。蒴果扁三角球形。种子每室1个，近圆形，直径1厘米。（标本信息来自中国植物志）普洱茶主要产于云南省的西双版纳、临沧、普洱等地区。普洱茶讲究冲泡技巧和品饮艺术，其饮用方法丰富，既可清饮，也可混饮。普洱茶茶汤橙黄浓厚，香气高锐持久，香型独特，滋味浓醇，经久耐泡。（概述图参考：）
浅口	百度百科是一部内容开放、自由的网络百科全书，旨在创造一个涵盖所有领域知识，服务所有互联网用户的中文知识性百科全书。在这里你可以参与词条编辑，分享贡献你的
ol	OL是英文“Office Lady”的缩写，中文解释为“白领女性”或者“办公室女职员”，通常指高学历、高压力、高收入的职业女性，OL打扮衣着入时，且具备一定办事能力，美丽与智慧兼备。
地中海	地中海 （拼音：dì zhōng hǎi ，英语：Mediterranean Sea，法语：Méditerranée，西班牙语：Mediterráneo，意大利语：Mediterraneo，希腊语：Μεσογείου，阿拉伯语：البحر الأبيض المتوسط ），是欧洲、非洲和亚洲大陆之间的一块海域。由北面的欧洲大陆，南面的非洲大陆和东面的亚洲大陆包围着，西面通过直布罗陀海峡与大西洋相连。东西共长约4000千米，南北最宽处约为1800千米，面积（包括马尔马拉海，但不包括黑海）约为251.2万平方千米，是世界最大的陆间海。地中海以亚平宁半岛、西西里岛和突尼斯之间的突尼斯海峡为界，分东、西两部分。地中海平均深度1450米，有记录的最深点是希腊南面的爱奥尼亚海盆，为海平面下5,121米。地中海盐度较高，最高达39.5‰ 。地中海是世界上最古老的海之一，历史比大西洋还要古老。地中海沿岸还
婴儿床	婴儿床是指给婴幼儿使用的床。现在的婴儿床款式多种多样，功能和价格也是相差也很大，选择时要注意安全和实用相结合的原则。婴儿床在使用中也存在一些安全隐患，父母应给予重视，及时排除隐患。婴儿床油漆是否符合安全标准，关键要看是否含有重金属和甲醛等有害成分。
美国进口	百度百科是一部内容开放、自由的网络百科全书，旨在创造一个涵盖所有领域知识，服务所有互联网用户的中文知识性百科全书。在这里你可以参与词条编辑，分享贡献你的
艺术	艺术是一个汉语词汇，拼音是yì shù。意思是指比现实有典型性的社会意识形态。艺术可以是宏观概念也可以是个体现象，是通过捕捉与挖掘、感受与分析、整合与运用（形体的组合过程、生物的生命过程、故事的发展过程）等方式对客观或主观对象进行感知、意识、思维、操作、表达等活动的过程，或是通过感受（看、听、嗅、触碰）得到的形式展示出来的阶段性结果。表达形式：语言、声音、文字、绘画、眼神、呼吸、肢体等。
年货	在春节置办年货是中国寻常百姓家不可或缺的头等大事，包括吃的、穿的、戴的、用的、耍的、供的、送的、干的、鲜的、生的、熟的，统名之曰“年货”，而把采购年货的过程称之为“办年货”。
钢带	钢在空气和水中容易生锈，而锌在大气中的腐蚀率仅为钢在大气中腐蚀率的1/15，镀锌钢板就是用微密的镀锌层保护钢板，免受腐蚀。钢带（steel-belt）是指以碳钢制成的输送带作为带式输送机的牵引和运载构件，也可用于捆扎货物；是各类轧钢企业为了适应不同工业部门工业化生产各类金属或机械产品的需要而生产的一种窄而长的钢板。钢带又称带钢，是宽度在1300mm以内，长度根据每卷的大小略有不同。带钢一般成卷供应，具有尺寸精度高、表面质量好、便于加工、节省材料等优点。钢带按所用材质分为普通带钢和优质带钢两类；按加工方法分热轧钢带、冷轧带钢带两种。
洗发水	洗发水，又名香波、洗发露、洗发精或者洗发膏，是目前应用最为广泛的洗发用品，也是最常用的发用化妆品之一。用于洗净附着在头皮和头发上的人体分泌的油脂，汗垢，头皮上脱落的细胞以及外来的灰尘、微生物、定型产品的残留物和不良气味等，保持头皮和头发清洁及头发美观。
运动服	运动服是指专用于体育运动竞赛的服装。广义上还包括从事户外体育活动所穿用的服装。运动服通常是按照运动项目的特定要求设计制作。运动服主要分为田径服、球类服、水上服、冰上服、举重服、摔跤服、体操服、登山服、击剑服9类。
挂饰	挂饰分类按搭配的物体不同，比较多的有吊坠挂饰、手机挂饰、包包挂饰，以及用于家居装饰的一些挂饰。
步鞋	百度百科是一部内容开放、自由的网络百科全书，旨在创造一个涵盖所有领域知识，服务所有互联网用户的中文知识性百科全书。在这里你可以参与词条编辑，分享贡献你的
哺乳	哺乳指动物产下幼仔以后，用自己乳腺分泌乳汁哺育幼仔的生物现象。乳汁中含有丰富的营养，还有一些抵御疾病的特殊抗体，因此对幼仔的生长发育极其有利。哺乳促进了动物最有效地保护和繁殖后代，是高等动物进化特征之一。猪、牛、羊等具有这种特征的动物，称为哺乳动物。
迪士尼	全球闻名遐迩的迪士尼，全称为The Walt Disney Company，取名自其创始人华特·迪士尼，是总部设在美国伯班克的大型跨国公司，主要业务包括娱乐节目制作，主题公园，玩具，图书，电子游戏和传媒网络。皮克斯动画工作室（PIXAR Animation Studio）、漫威电影公司（Marvel Entertainment Inc）、试金石电影公司（Touchstone Pictures）、米拉麦克斯（Miramax）电影公司、博伟影视公司（Buena Vista Home Entertainment）、好莱坞电影公司（Hollywood Pictures）、ESPN体育，美国广播公司（ABC）都是其旗下的公司（品牌）。迪士尼于2012年11月收购了卢卡斯影业。2018年12月，世界品牌实验室编制的《2018世界品牌500强》揭晓，迪士尼排名第23
客厅家具	客厅家具，指摆放于客厅中家具的统称。客厅家具包括但不限于沙发、茶几、角几、电视柜、地柜、鞋柜、花架、报架、CD架、装饰柜、酒柜等。当今的客厅家具设计，其实是设计一种新的生活、工作、休闲与娱乐的方式。人们讲究客厅家具的色调与居室装修协调，同时能体现主人的性情和爱好。客厅家具趋于简约、清瘦、实用，一些客厅家具甚至用纸板制作。其产品设计利用力学原理，做成的家具有足够的强度，同时在家具表面涂上保护漆，经过特殊处理，解决了不耐压和怕水的两大弱点，使纸制的家具具有一定的防潮、防水、防霉、防虫蛀等功能。
产后	产后指的是孕妇分娩以后的一段时间。生产后，女性身体流失了大量养分，所以在产后的这一段时间内，饮食、护理、恢复对女性来说都非常重要。
女裤	女裤（knicker），妇女穿的裤子，在腰右面边上开衩。一般男人的门襟比女人的门襟要长一些。
果盘	从水果的色泽、形状、口味、营养价值、外观完美度等多方面对水果进行选择。选择的几种水果组合在一起，搭配应协调。最重要的一点是水果本身应是熟的、新鲜的、卫生的。同时注意制作拼盘的水果不能太熟，否则会影响加工和摆放。
绿茶	绿茶（Green Tea），是中国的主要茶类之一，是指采取茶树的新叶或芽，未经发酵，经杀青、整形、烘干等工艺而制作的饮品。其制成品的色泽和冲泡后的茶汤较多的保存了鲜茶叶的绿色格调。常饮绿茶能防癌，降脂和减肥，对吸烟者也可减轻其受到的尼古丁伤害。绿茶是未经发酵制成的茶，保留了鲜叶的天然物质，含有的茶多酚、儿茶素、叶绿素、咖啡碱、氨基酸、维生素等营养成分也较多。绿茶中的这些天然营养成份对防衰老、防癌、抗癌、杀菌、消炎等具有特殊效果，是其他茶类所不及的。绿茶是以适宜茶树新梢为原料，经杀青、揉捻、干燥等典型工艺过程制成的茶叶。其干茶色泽和冲泡后的茶汤、叶底以绿色为主调，故名绿茶。绿茶是将采摘来的鲜叶先经高温杀青，杀灭了各种氧化酶，保持了茶叶绿色，然后经揉捻、干燥而制成，清汤绿叶是绿茶品质的共同特点。中国生产绿茶的范围极为广泛，河南、贵州、江西、安徽、浙江、江苏、四川、陕西（陕南）、湖南、湖北、广西
500ml	规格 : 注射剂剂型 : 2002-7-10批准日期 : 国药准字H12020564药品类型 : Compound Electrolytes and Glucose Injection MG3英文名称 : 津卫药准字（1994）第002500号
三角	《Triangle》是韩国MBC电视台自2014年5月5日起在月火档播出的亲情剧。由崔完圭编剧，柳哲容导演，金在中、李凡秀、任时完、白珍熙、吴妍秀等主演。该剧讲述了失去父母的三兄弟，从小被迫分开生活了20多年却不知道互相的存在，又因机缘巧合开始寻找对方，在此过程中发生的关于爱情与成功的故事。
手柄	手柄是一种机械配件，方便工人操作机械。机械附件行业手柄有主要有两类材质分别是塑料、钢件。钢件有机床加工的和铸件区分。塑料手柄有热固性塑料和热塑性塑料之分。
床品	床品是家纺的重要组成部分，按照中国家纺协会的分类，包括：床品类，窗帘类，洗漱厨房纺织品类，家具类纺织类（靠垫、座垫）等。其中床品类别占据家纺行业第一位，产值占中国家纺业1/3以上，2004年达到1000亿人民币；2006年产值在2500亿元左右，包括床单、被子、枕头等产品。在中国，床品业又称为寝装业，或者叫寝具业、卧具业及室内软装饰业，不过目前多数行业人士还是习惯使用家纺行业的大概念。床品主要包括：枕芯、被褥、床垫、枕套、被套等。
女式	百度百科是一部内容开放、自由的网络百科全书，旨在创造一个涵盖所有领域知识，服务所有互联网用户的中文知识性百科全书。在这里你可以参与词条编辑，分享贡献你的
运动套装	百度百科是一部内容开放、自由的网络百科全书，旨在创造一个涵盖所有领域知识，服务所有互联网用户的中文知识性百科全书。在这里你可以参与词条编辑，分享贡献你的
花架	用刚性材料构成一定形状的格架供攀缘植物攀附的园林设施，又称棚架、绿廊。花架可作遮荫休息之用，并可点缀园景。花架设计要了解所配置植物的原产地和生长习性，以创造适宜于植物生长的条件和造型的要求。现在的花架，有两方面作用。一方面供人歇足休息、欣赏风景；一方面创造攀援植物生长的条件。因此可以说花架是最接近于自然的园林小品了。
无痕	广播剧网络配音CV，广播剧剧团星之声中文配音组成员，声音特点：温和男青年音，属性：正直、略呆萌、有时略二。
眼镜	眼镜是镶嵌在框架内的透镜镜片，戴在眼睛前方，以改善视力、保护眼睛或作装饰用途。镜可矫正多种视力问题，包括近视、远视、散光、老花或斜视、弱视等。眼镜由镜片、镜架组成。分近视眼镜、远视眼镜、老花镜及散光眼镜、平光眼镜、电脑护目镜、护目镜、泳镜、夜视镜、电竞游戏护目镜、电竞护目镜、风镜、墨镜、玩具眼镜、太阳眼镜15种。亦有特制眼镜供观看3D立体影像或虚拟真实影像。眼镜的其他种类包括护目镜，太阳镜，游泳镜等，为眼睛提供各种保护。现代的眼镜，通常在镜片中间设有鼻托，及在左右两臂搁在耳朵上的位置设有软垫。爱美或不习惯佩戴眼镜的人，可以选择以隐形眼镜矫正视力。虽然近年隐形眼镜及激光矫视手术越来越普及，但佩戴眼镜仍然是安全有效的矫正视力工具。
真皮沙发	真皮沙发属于沙发的一种，真皮沙发其实是个泛称，牛皮、猪皮、马皮、驴皮都可以用作沙发原料。真皮有天然毛孔和皮纹，手感丰满、柔软，富有弹性，所以真皮沙发也备受人们喜爱。
生日	生日，顾名思义是指人出生之日，也是每年满周岁的那一天。但有些地方的民俗认为，这同时也是母亲的“受难日”。因为以前的科技不像现在日新月异，那时的母亲生孩子，有“一只脚在棺材里，一只脚在棺材外”一说。所以，他们觉得在那天，应该以孝敬母亲为主。
松紧	松紧，指松或紧的程度。如：宽严松紧要适可而止。
浓香型	中国产白酒的香型之一。采用老窖位发酵生香基地，窖愈老，窖泥中的酿酒微生物愈多，生产的酒愈好。浓香型白酒其酒味芳香浓郁，绵柔甘烈，香味协调，绵甘适口，回味悠长。浓香型白酒：窖香浓郁，口味丰满，入口绵甜干净，纯正。如以泸州特曲、五粮液、剑南春、全兴大曲、沱牌曲酒为代表的四川派，以洋河、双沟、古井、宋河粮液百年皖酒为代表的纯浓派。
浪漫	广义上的浪漫，意为纵情；浪漫；富有诗意，充满幻想；不拘小节（情侣关系而言）。此词来自于西方词语Romantic音译的演变而成，其作用就是为了翻译Romantic。至于说出自宋·苏轼《与孟震同游常州僧舍》诗之一：“年来转觉此生浮，又作三吴浪漫游。”中的“浪漫”二字，并不是一个词语，而是两个并列字，诗中此二字的意义与现在浪漫一词的意思不同。狭义上的浪漫来源于19世纪20年代至19世纪末诞生于西欧的浪漫主义，这里的浪漫特指对现实世界感到不满，对未来充满期望和追求，理想远大，不甘堕落的个人英雄主义情怀。
纸巾盒	纸巾盒是指盒体顶面开设有取纸口并设有用于盖住取纸口的封盖。
oversize	百度百科是一部内容开放、自由的网络百科全书，旨在创造一个涵盖所有领域知识，服务所有互联网用户的中文知识性百科全书。在这里你可以参与词条编辑，分享贡献你的
墙面	墙体的表面，一般在室内装修时提到比较多。墙面装修处理一般是刷漆或者粘壁纸。
迪卡侬	迪卡侬来自于法国，是体育用品零售商，由米歇尔·雷勒克于1976年创立，第一家店开在法国里尔附近的小村庄恩洛斯。2003年迪卡侬进入中国，至目前已遍布全国46座城市178家商场。提供连锁运动用品经营以至体育全产业链的支持，并有丰富的自有品牌产品阵线，并根据运动类别的不同，分为20种不同名称品牌。对于初学者和专业运动者，迪卡侬都能提供运动服饰、装备以及各种创意类运动产品，其全产业链掌控的模式让其产品具有较高的性价比。2018年12月，世界品牌实验室发布《2018世界品牌500强》榜单，迪卡侬排名第484。
洗漱	洗脸漱口，对面部器官的清洗。指个人卫生的统称，现在也有好多内容，包括化妆、卸妆、洗头、贴面膜、喷香水等
唇膏	唇膏是最原始、最常见的口红的一种，一般是固体，质地比唇彩和唇蜜要干和硬。唇膏已成了我国现代女性的常用化妆品。在口唇上涂一层恰到好处的唇膏能使人显得格外娇媚。色彩饱和度高，颜色遮盖力强，而且由于是固体一般不容易由于唇纹过深而外溢，常用它来修饰唇形、唇色。
旅行包	旅行包又叫旅游包，顾名思义就是指为旅行或者旅游而准备的一类包。是在离开家乡去远行，或做事或游览，或者投身于大自然中享受着阳光雨露时，可以将日常用品或者想带在身边的任何东西装起来以便于携带方便的一类包。旅行包可分为背包、提包和拖拉包。 在选择时，要考虑容积和款式，此外还应考虑使用者的身材和体形以及负重能力等因素，
化妆	《化妆》是韩国人气歌手金在中演唱的一首歌曲。这首歌的原唱是日本著名歌姬中岛美雪，金在中在个人日本巡回Fan Meeting上翻唱日语版本后将它重新编曲，并在原作基础上自己重新填词，完成了韩语版本。此曲收录于2014年01月20日发行的金在中Repakege个人solo专辑《WWW卸妆》中，是该专辑的主打歌之一，列于专辑第2位 。
水杯子	百度百科是一部内容开放、自由的网络百科全书，旨在创造一个涵盖所有领域知识，服务所有互联网用户的中文知识性百科全书。在这里你可以参与词条编辑，分享贡献你的
抽屉	抽屉（ chōu ti）桌子、柜子等家具中放东西用的匣子，有底，没盖，可以抽出来推进去。
男生	男，是指一名雄性人类，与雌性人类，也就是女性相对。男这个名词是用来表示生物学上的性别划分，正式只适用于称呼人类，但有时侯也会用作称呼其他生物。在汉语中，男解作：⒈、阳性的人，与「女」相对。⒉、指儿子，如长男。3、古代爵位的第五等。男生，原指还处于受教育阶段的男性学生。后来“男生”的含义则引申到所有年轻的男性。
护肤	护肤在现代已经成为一门学问，人们受皮肤问题困扰不再盲目地去商店买各种化妆品来试，而是由皮肤科医生开出处方，提供针对性的护肤建议。随着人们对健康的追求日益高涨和皮肤医学的高速发展，带有更高安全性和有效性的医学护肤品已经成为不可阻挡的一股潮流。伴随更多的女性开始注重护肤品的质量和安全性，专业人员对皮肤及其附属器的结构和生理作用研究和认识更深入，对化妆品的研究更专业化，性能更具有针对性、可靠性和竞争力。
毛线	毛线：羊毛纺成的纱毛线：漫画《堕玄师》玄兽
200g	百度百科是一部内容开放、自由的网络百科全书，旨在创造一个涵盖所有领域知识，服务所有互联网用户的中文知识性百科全书。在这里你可以参与词条编辑，分享贡献你的
烤箱	烤箱是一种密封的用来烤食物或烘干产品的电器，分为家用电器和工业烤箱。 家用烤箱可以用来加工一些面食。 工业烤箱，为工业上用来烘干产品的一种设备，有电的、有瓦斯的，又叫烤炉、烘干箱等。电烤箱是利用电热元件所发出的辐射热来烘烤食品的电热器具，利用它我们可以制作烤鸡、烤鸭、烘烤面包、糕点等。根据烘烤食品的不同需要，电烤箱的温度一般可在50-250℃范围内调节。
棉裤	棉裤指中间絮了棉花的裤子，包括婴儿的包脚款式，儿童的簸箕裤，成人的修身松紧带棉裤和老人的分门襟棉裤。
男青年	百度百科是一部内容开放、自由的网络百科全书，旨在创造一个涵盖所有领域知识，服务所有互联网用户的中文知识性百科全书。在这里你可以参与词条编辑，分享贡献你的
时钟	时钟是生活中常用的一种计时器，人们通过它来记录时间。至今为止，在中国历史上有留下记载的四代计时器分别为：日晷、沙漏、机械钟、石英钟。
安全	安全是一个汉语词语，拼音是ān quán，通常指人没有受到威胁、危险、危害、损失。人类的整体与生存环境资源的和谐相处，互相不伤害，不存在危险的隐患，是免除了不可接受的损害风险的状态。安全是在人类生产过程中，将系统的运行状态对人类的生命、财产、环境可能产生的损害控制在人类能接受水平以下的状态。中国当前的国家安全观：政治安全、国土安全、军事安全、经济安全、文化安全、社会安全、科
坎肩	坎肩，无袖短上衣。传统的坎肩，套在夹衣、毛衣、薄棉衣外面，有棉坎肩、皮坎肩等，增强肩部御寒，多无领。后来的西服坎肩、时装坎肩，紧身无领，又称马甲，名称来源于骑兵甲胄。
短外套	百度百科是一部内容开放、自由的网络百科全书，旨在创造一个涵盖所有领域知识，服务所有互联网用户的中文知识性百科全书。在这里你可以参与词条编辑，分享贡献你的
套件	百度百科是一部内容开放、自由的网络百科全书，旨在创造一个涵盖所有领域知识，服务所有互联网用户的中文知识性百科全书。在这里你可以参与词条编辑，分享贡献你的
床上	床上是立方网推出的一款睡前导读应用，现已推出Android 4.8.0版。用户可以用它听音乐，读精品文章，赠送精美礼品给自己喜欢的用户，与同城用户聊天，分享自己的照片给其他用户，或者加入群聊和全国的床上用户一起聊天。床上群聊中会不定期推出美女话题主持人引导群聊氛围。
飞利浦	飞利浦，1891年成立于荷兰，主要生产照明、家庭电器、医疗系统方面的产品。飞利浦公司，2007年全球员工已达128,100人，在全球28个国家有生产基地，在150个国家设有销售机构，拥有8万项专利，实力超群。2011年7月11日，飞利浦宣布收购奔腾电器（上海）有限公司，金额约25亿元。2011年10月17日，飞利浦电子发布了第三季度财报，第三季度净利润同比下滑85.9%；同时宣布，飞利浦将在全球范围内裁员4500人。2013年1月底，飞利浦消费电子业务已全部剥离，将聚焦优质生活，医疗和照明设备行业。北京时间2014年12月17日，飞利浦宣布，将以12亿美元收购美国医疗设备制造商Volcano公司。2018年7月19日，《财富》世界500强排行榜发布，飞利浦位列423位。2018年12月18日，世界品牌实验室编制的《2018世界品牌500强》揭晓，飞利浦排名第53位。
煲汤	餐桌上有碗热气腾腾的鲜汤，常使人垂涎欲滴，特别是在冬春季，汤既能助人取暖，又能使人的胃口大开。 煲汤往往选择富含蛋白质的动物原料，最好用牛、羊、猪骨和鸡、鸭骨等。其做法是：先把原料洗净，入锅后一次加足冷水，用旺火煮沸，再改用小火，持续20分钟，撇沫，加姜和料酒等调料，待水再沸后用中火保持沸腾3～4小时，使原料里的蛋白质更多地溶解， 浓汤呈乳白色，冷却后能凝固可视为汤熬到家了。
墙纸	墙纸也称为壁纸，是一种用于裱糊墙面的室内装修材料，广泛用于住宅、办公室、宾馆、酒店的室内装修等。材质不局限于纸，也包含其他材料。歧义：墙纸容易和桌面壁纸混淆，后者是设置于电脑桌面的图片。因为具有色彩多样、图案丰富、豪华气派、安全环保、施工方便、价格适宜等多种其它室内装饰材料所无法比拟的特点，故在欧美、日本等发达国家和地区得到相当程度的普及。壁纸分为很多类，如覆膜壁纸、涂布壁纸、压花壁纸等。通常用漂白化学木浆生产原纸，再经不同工序的加工处理，如涂布、印刷、压纹或表面覆塑，最后经裁切、包装后出厂。具有一定的强度、韧度、美观的外表和良好的抗水性能。
女表	女表，读音是nǚ biǎo，汉语词语，释义是女子的表率。
套头衫	套头衫就是就是穿的时候直接从头上套进去的那种衣服，前面没扣子没有拉链。 套头衫青春洋溢的风格受到所有时尚MM的一致追捧。
儿童床	儿童床又名摇篮床，指儿童使用的床，特点是安全实用，儿童床有传统的、经典的，现代的和更流行的。儿童床跟多的是按年龄段划分类别。儿童床有功能多的、单一的，摇床、摇椅能来回变，功能越多结构越复杂。如果功能多，从一种功能转换成另一种功能装卸时要注意，安装到位；单一功能只有一条，安装好了，永远不动了，就没有危险。
吊坠	吊坠，一种首饰，配戴在脖子上的饰品，多为金属制，特别是不锈钢制和银制，也有矿石、水晶、玉石等制的，主要是用于祈求平安，镇定心志和美观。
名媛	名媛是一个源自古代、在20世纪三十年代开始流行的一个称谓，一般是指那些出身名门、有才有貌、又经常出入时尚社交场的美女。现代名媛亦有时尚界及名人界之有名及社会有钱人士，包括归国富人或归国子女，或是凭自己努力所赚取的地位。但对于明星与名流的关系上有争议，在电视节目《大学生了没》中三位名流嘉宾曾讨论不是所有演艺圈人员都可称之为名流。中文的名流定义和英文Celebrities可能不完全为同一类意思，亦有花卉的意思。名流本来是指“名士”一类的人物，即“名士之流”，女性则称为名媛。
战术	指导和进行战斗的方法。主要包括：战斗基本原则以及战斗部署、协同动作、战斗指挥、战斗行动、战斗保障、后勤保障和技术保障等。按基本战斗类型分为进攻战术和防御战术；按参加战斗的军种、兵种分为军种战术、兵种战术和合同战术；按战斗规模分为兵团战术、部队战术和分队战术。
干果	干果，即果实果皮成熟后为干燥状态的果子。干果又分为裂果和闭果，它们大多含有丰富的蛋白质，维生素，脂质等。我们生活中常见的干果有很多，例如板栗、锥栗、霹雳果、榛子、腰果、核桃、瓜子、松仁、杏仁、白果、开心果、碧根果、沙漠果、榧子、白瓜子、南瓜子、花生、巴旦木 、夏威夷果等。
一字	一字，看似简单，但在佛教、中医、词语中都有不同的意思。如：佛教，一字者，本无名无字。中医，一字是指一个单位。总之，“一”字在不同地方有多种不同的解释。惟佛如来究尽明了。经云。法惟一字。所谓无字。是也。
提花	提花，就是纺织物以经线﹑纬线交错组成的凹凸花纹。纺织品类别众多，提花面料为其中一大类别。提花面料又可分为家纺用料和时装面料，早在古丝绸之路，中国丝绸就以提花织造的方式名扬世界。绣花只是一种装饰，一般绣花的都是平纹加密的布料，而提花的算是比较高档些的了，能够提出图案来对棉纱的要求就高，质量次的棉纱也无法提出成型的图案，提花也是分平纹提花和斜纹提花。
防尘	防尘 ，读音fáng chén，汉语词语，基本意思为不透尘埃的;紧得灰尘不能进入的。
多肉	多肉植物（succulent plant）是指植物的根、茎、叶三种营养器官中叶是肥厚多汁并且具备储藏大量水分功能的植物，也称“多浆植物”。其至少具有一种肉质组织，这种组织是一种活组织，除其他功能外，它能储藏可利用的水，在土壤含水状况恶化、植物根系不能再从土壤中吸收和提供必要的水分时，它能使植物暂时脱离外界水分供应而独立生存。据粗略统计，全世界共有多肉植物一万余种，在分类上隶属100余科。
爽肤水	爽肤水有的含有微量的酒精，有些是纯植物配方的。 爽肤水它的作用就在于再次清洁以恢复肌肤表面的酸碱值，并调理角质层，使肌肤更好地吸收，并为使用保养品作准备。洗完脸之后，使用爽肤水，可以迅速补充水分。专家建议油性皮肤使用紧肤水，健康皮肤使用爽肤水，干性皮肤使用柔肤水，混合皮肤T区使用紧肤水，敏感皮肤选用敏感水、修复水。
商用	百度百科是一部内容开放、自由的网络百科全书，旨在创造一个涵盖所有领域知识，服务所有互联网用户的中文知识性百科全书。在这里你可以参与词条编辑，分享贡献你的
健身器材	健身器材常以训练功能多少来分为单功能和综合型多功能两大类，常用的有划船器、健美车、健步机、跑步机、美腰机等。
筷子	筷子，是指中国常用的饮食工具，通常由竹、木、骨、瓷、象牙、金属、塑料等材料制作。是世界上常用餐具之一，中华饮食文化的标志之一，发明于中国，后传至朝鲜、日本、越南等汉字文化圈。中国人习惯用筷子，而非洲、中东、印度尼西亚及印度次大陆等地区的人则用手指去抓取。中国目前发现的最早筷子是河南省安阳市殷墟出土的铜筷子。《韩非子·喻老》言：“昔者纣为象箸，而箕子怖。”纣王为商朝末期的国君，可见3000多年前的中国就已经出现象牙筷子。
奶茶	奶茶原为蒙古高原游牧民族的日常饮品，至今最少已有千年历史。蒙古高原是游牧民族的故乡，也是奶茶的发源地，最初最正宗的就是蒙古奶茶。自元朝起传遍世界各地，目前在大中华地区，中亚国家，印度，阿拉伯，英国，马来西亚，新加坡等地区都有不同种类奶茶流行。蒙古高原和中亚地区的奶茶千百年来从未改变，至今仍然是日常饮用及待客的必备饮料。其他地区则有不同口味的奶茶，如印度奶茶以加入玛萨拉的特殊香料闻名；发源于香港的丝袜奶茶和发源于台湾的珍珠奶茶也独具特色。奶茶兼具
红茶	《红茶》是葛雨晴与钟晓仪共同创作演绎的一首歌曲，发行于2015-12-01日。
男子	男子，即男性的成年人。出自《礼记·曲礼上》。
旅行箱	旅行箱，（suitcase）是箱包中的一类。它包括有箱包体、伸缩拉杆和箱包底轮，因其使用方便而受到广泛使用。旅行箱有着漫长的历史。旅行箱，从仅供容纳衣物的木箱、大皮箱，到如今形态各异的便携式手提箱、拉杆箱，人们手中的旅行箱在不断演进。
英国	大不列颠及北爱尔兰联合王国（United Kingdom of Great Britain and Northern Ireland），简称联合王国（United Kingdom），通称英国。本土位于欧洲大陆西北面的不列颠群岛，被北海、英吉利海峡、凯尔特海、爱尔兰海和大西洋包围。英国是由大不列颠岛上的英格兰、威尔士和苏格兰以及爱尔兰岛东北部的北爱尔兰以及一系列附属岛屿共同组成的一个西欧岛国。除本土之外，其还拥有十四个海外领地，总人口超过6600万，其中以英格兰人（盎格鲁-撒克逊人）为
湿巾	湿巾是用来擦拭皮肤的湿润的纸巾。市场上的湿巾大致可以分为两类：一类是本身已经被消毒，但不能消毒其他物品，里面含有护肤的成分，只能做皮肤湿润保养的。另一类是不仅本身被消毒，而且对别的物品也可起到消毒作用的消毒湿巾，可以用做皮肤擦伤、划伤等的消毒或杀菌。选购湿巾的时候一定要看清湿巾纸的功能和定位。
午睡	午睡，是一个汉语词汇。由于我们体内的生物节律在起作用。而午睡恰恰是人体保护生物节律的一种方法。
拉杆箱	拉杆箱指具有拉杆和滚轮的行李箱。因其使用方便而广泛使用。同时，拉杆箱也因箱子置一拉杆，有单管拉杆及双管拉杆之分，拉杆的管亦有方管和圆管之分，以方便行走时拖着，大大减轻负担。拉杆箱可以手提也可以拖动，我们平时所用的拉杆箱的轮子基本都位于箱子底部，而现代人又设计出了一款新形态的拉杆箱，将箱子设计成了圆筒的造型，轮子则整个外包在箱子外侧，这样的滚筒设计使得这款拉杆箱可以更好的适应不同的地形，如直接拉着箱子就可以轻松上下楼梯。2012年主要以布箱、ABS硬箱、皮箱、PC等为主要材质，并将使用性分为定向轮、万向轮以及最新的可拆卸万向轮拉杆箱三大类。
二合一	《二合一》是gwf小龙飞写的网络小说连载于起点中文网。
餐边	百度百科是一部内容开放、自由的网络百科全书，旨在创造一个涵盖所有领域知识，服务所有互联网用户的中文知识性百科全书。在这里你可以参与词条编辑，分享贡献你的
厕所	厕所泛指由人类建造专供人类（或其他特指生物，如家畜）进行生理排泄和放置（处理）排泄物的地方。 人类使用的厕所大多有男厕女厕之分，不过随着科技的发展，男女共用的厕所，也问世了。厕所的名称有很多，有的地方叫窖，有的叫茅房，文雅一点的叫洗手间、盥洗室。潮汕地区则延续唐朝时的叫法称之为“东司”或者“东厮”。厕所也有外文名字，有叫Toilet，有叫Men'room的。上厕所也有很多种叫法，古代叫更衣，后来叫解手，现代叫方便，叫如厕，叫出恭，上洗手间。通俗的叫大便小便，文雅的叫洗手。西方人把上厕所说成是摘花，日本男人在野外方便叫打猎。上厕所一般分为蹲便和坐便两种形式，蹲厕以亚洲人居多，所以叫亚洲蹲，坐便现在也成为中国人家庭的标配了。
美白	因为“一白遮三丑”的传统美观念，女性对于美白有执着的追求。各类美白产品与美白方法层出不穷，请谨慎判断，选用适合的美白手段。
新货	百度百科是一部内容开放、自由的网络百科全书，旨在创造一个涵盖所有领域知识，服务所有互联网用户的中文知识性百科全书。在这里你可以参与词条编辑，分享贡献你的
梳妆台	梳妆台指用来化妆的家具装饰。梳妆台一词，在现代家居中，已经被业主、客户、家居设计师广泛用到，现在泛指家具梳妆台。梳妆台尺寸标准的是总高度为1500mm左右，宽为700mm到1200mm，这样的梳妆台尺寸是大小正合适的，在家庭装修之前的前期准备时，就应该确定好梳妆台尺寸大小，同时梳妆台尺寸也要和房间的格调和风格统一起来。
水果盘	水果盘英文为Fresh Fruit Platter ，是一种主要盛放水果、瓜子等的容器，具有方便、循环利用、时尚等特点。
云南	云南省，简称“云”或“滇”，是中华人民共和国省级行政区，省会昆明。位于中国西南边陲，界于北纬21°8′-29°15′，东经97°31′-106°11′之间，东部与贵州、广西为邻，北部与四川相连，西北部紧依西藏，西部与缅甸接壤，南部和老挝、越南毗邻，云南省总面积39.4万平方千米。云南省地势呈现西北高、东南低，自北向南呈阶梯状逐级下降，属山地高原地形，山地面积占全省总面积的88.64%。地形以元江谷地和云岭山脉南段宽谷为界，分为东西两大地形区。东部为滇东、滇中高原，是云贵高原的组成部分，表现为起伏和缓的低山和浑圆丘陵；西部高山峡谷相间，地势险峻，形成奇异、雄伟的山岳冰川地貌。云南省地跨长江、珠江、元江、澜沧江、怒江、
123	123（一百二十三），是122和124之间的一个自然数、奇数（单数）、合数、阿拉伯数字、有理数。是最简单的数列组合。
电脑包	电脑包属于3C数码配件以及箱包产品类别，随着笔记本的出现而出现。用来装笔记本和公文资料的箱包。有电脑包和内胆包之分，海外通常叫“电脑商务袋、内袋”。
果汁	果汁是以水果为原料经过物理方法如压榨、离心、萃取等得到的汁液产品，一般是指纯果汁或100%果汁。果汁按形态分为澄清果汁和混浊果汁。澄清果汁澄清透明，如苹果汁，而混浊果汁均匀混浊，如橙汁；按果汁含量分为原果汁、水果汁、果汁饮料、果粒果汁饮料、果汁类汽水、果味型饮料。
品牌	品牌是一个汉语词语，拼音是pǐn pái，是指消费者对产品及产品系列的认知程度。广义的“品牌”是具有经济价值的无形资产，用抽象化的、特有的、能识别的心智概念来表现其差异性，从而在人们的意识当中占据一定位置的综合反映。品牌建设具有长期性。狭义的“品牌”是一种拥有对内对外两面性的“标准”或“规则”，是通过对理念、行为、视觉、听觉四方面进行标准化、规则化，使之具备特有性、价值性、长期性、认知性的一种识别系统总称。这套系统我们也称之为CIS（corporate identity system）体系。现代营销学之父科特勒在《市场营销学》中的定义，品牌是销售者向购买者长期提供的一组特定的特点、利益和服务。品牌是给拥有者带来溢价、产生增值的一种无形的资产，它的载体是用于和其他竞争者的产品或劳务相区分的名称、术语、象征、记号或者设计及其组合，增值的源泉来自于消费者心智中形成的关于其载体的印象。品牌承载的更
推车	推车是以人力推和拉的搬运车辆。推车有独轮、两轮、三轮和四轮之分。传统推车的车体材质一般为木质，现代生产的推车车体材质一般为铁皮。
狐狸	哺乳纲，食肉目犬科动物。属于一般所说的狐狸，又叫红狐、赤狐和草狐。它们灵活的耳朵能对声音进行准确定位、嗅觉灵敏，修长的腿能够快速奔跑，最高时速可达50km/h左右，所以主要以鱼、蚌、虾、蟹、鼠类、鸟类、昆虫类小型动物为食，有时也采食一些植物。实际上狐狸是民间对这一类动物的通称，种类繁多，分北极狐、赤狐、银黑狐、沙狐等。性格机敏胆小，常在古代神话中以"狐狸精"出现，虽在远古也曾作为图腾，但从不出现于正式祭祀中，皆因其"形象不雅"，多与狡诈鬼祟相关联。多年来，狐妖狐仙，在各种小说及趣闻中形成一种独有的妖精文化。
甜品	甜品，也叫甜点，是一个很广的概念，大致分为甜味点心和广式的糖水。甜品，一般不会被当作正餐，通常作为下午茶的小食。甜食，是治疗抑郁、放松心情的灵丹妙药，大多人在犒劳自己的时候喜欢来一点甜的，忘记减肥、忘记塑身、忘记那些好看但绷着身体的华丽衣服。一般来说，喜欢吃甜食的人，脾气都不坏，她们的坏情绪可以被巧克力、蛋糕、布丁、奶酪等一切甜美的食物代谢殆尽。即便如才女张爱玲也对冰淇凌、蛋糕等甜品“爱不释口”，尤其喜欢老上海凯司令的“栗子蛋糕”和“处女冰淇淋”。其实女人和甜品有着诸多共同点。首先两者都有吸引人的外观，或精致，或秀美，所谓秀色可餐。其次两者的内在都细腻、柔软。有时女人会用看似冰冷的外表保护自己，其实内心如水，就像巧克力蛋糕，外面是一层坚硬的壳，但里面却是绵密的奶油，极易被热情融化。所以，懂得欣赏甜品的男士必定也会懂得欣赏女人；要让心爱的她感到甜蜜，就为她准备一道特别的甜品吧！广东糖水甜品的
雕花	雕花为多义词，主要意向包括：①一种工艺，在木器上或房屋的隔扇、窗户等上头雕刻图案、花纹：～匠。 ②雕刻成的图案、花纹。 
工艺品	工艺品（英：art craft）手工艺的产品。即通过手工或机器将原料或半成品加工而成的有艺术价值的产品。工艺品来源于生活，却又创造了高于生活的价值。它是人民智慧的结晶，充分体现了人类的创造性和艺术性， 是人类的无价之宝。
牙刷	牙刷是一种清洁用品，为手柄式刷子，用于在刷子上添加牙膏，然后反复刷洗牙齿各个部位。最早的牙刷来源于中国。
随身	随身，指带在身边；跟在身旁，随身携带。见《汉书·货殖传·程郑》：“裒（ 罗裒 ）贾京师，随身数十百万，为平陵石氏持钱。”
机械	《机械》杂志是国内外公开发行的机械装备行业专业技术期刊，在机械行业领域内，传播科技信息，刊载科技专题论著，展示机学科最新科研成果，交流生产实践及革新改造的先进技术经验，传播现代科技新知识。创刊50年来，《机械》杂志由最初的不定期发行内部期刊发展成为国内外公开发行的综合性机械工程技术期刊，曾连续两次被评为中国中文核心期刊，并陆续被中国知网、中国学术期刊（光盘版）、万方数据－数字化期刊群、中国学术期刊综合评价数据库、中文科技期刊数据库全文、中国核心期刊（遴选）数据库等国内知名数据库全文收录。《机械》杂志曾多次被评为四川省优秀期刊，并两度获得中国机械工程学会工作成果奖。
插花	插花(floarr)，亦可称为插花艺术，就是把花插在瓶、盘、盆等容器里，而不是栽在这些容器中。所插的花材，或枝、或花、或叶，均不带根，只是植物体上的一部分，并且不是随便乱插的，而是根据一定的构思来选材，遵循一定的创作法则，插成一个优美的形体（造型），借此表达一种主题，传递一种感情和情趣，使人看后赏心悦目，获得精神上的美感和愉快。中国插花是一种古老的传统文化现象，大多为满足主观与情感的需求，亦是日常生活进行娱乐的特殊方式。插花源于古代民间的爱花、种花、赏花、摘花、赠花、佩花、簪花。花束的花材固定有两种方法：一种是用细铁丝绑扎。每一枝花、每一片衬叶，都用缠上绿胶带的细铁丝缠好后再造型。另一种是用专用花托，内有花泥，将花依造型插入花托内，此法比较简便省事。
环保	环保，全称环境保护，是指人类为解决现实的或潜在的环境问题，协调人类与环境的关系，保障经济、社会的持续发展而采取的各种行动的总称。其方法和手段有工程技术的、行政管理的、创新研发的，也有法律的、经济的、宣传教育的等。
加热	加热是指热源将热能传给较冷物体而使其变热的过程。一般的外在表现为温度的升高，可以用温度计等设备直接测量。加热的方式一般可分为直接加热和间接加热两大类。
超长	百度百科是一部内容开放、自由的网络百科全书，旨在创造一个涵盖所有领域知识，服务所有互联网用户的中文知识性百科全书。在这里你可以参与词条编辑，分享贡献你的
国潮	百度百科是一部内容开放、自由的网络百科全书，旨在创造一个涵盖所有领域知识，服务所有互联网用户的中文知识性百科全书。在这里你可以参与词条编辑，分享贡献你的
厚款	厚款是一个汉字词语，意思是厚意款待。
精油	精油是从植物的花、叶、茎、根或果实中，通过水蒸气蒸馏法、挤压法、冷浸法或溶剂提取法提炼萃取的挥发性芳香物质。精油又分稀释的（复方精油）和未经稀释的（单方精油）比如仙人掌种子油。精油的挥发性很强，一旦接触空气就会很快挥发，所以精油必须用可以密封的深色瓶子储存。
石英	石英，女，1965年4月生，广州军区广州总医院普通外科护士长。
桌子	《桌子》是一部有金宗宽导演、编剧，林秀晶、郑有美、韩艺礼、郑恩彩、延宇振主演的韩国电影。讲述了在一间咖啡厅的一个桌子，一天之内在这里发生的四对情侣的故事。该片于2016年10月7日在釜山电影节首映。
瓶装	百度百科是一部内容开放、自由的网络百科全书，旨在创造一个涵盖所有领域知识，服务所有互联网用户的中文知识性百科全书。在这里你可以参与词条编辑，分享贡献你的
煎锅	煎锅，海盐制盐器具。铁制。圆形。口径约1米，深约0．35米，池盐制盐器具。铁制。圆形。直径约1．4米。 
职业	根据中国职业规划师协会的定义：职业=职能*行业，这样才能算是一个完整的职业。
宜兴	宜兴市，简称宜，古称“荆邑”、“阳羡”，位于江苏南部，太湖西岸。宜兴是中国著名陶都。宜兴素有“陶的古都，洞的世界，茶的绿洲，竹的海洋”之称。宜兴是“紫砂壶”原产地，拥有石灰岩溶洞80多个，茶园3500余公顷，竹海纵横八百里。宋代大诗人苏东坡在宜兴留下“买田阳羡吾将老，从初只为溪山好”的诗句。宜兴人文荟萃，诞生了4位状元、10位宰相、26位两院院士，被誉为院士教授之乡。宜兴属吴越文化，是江浙民系使用吴语。宜兴市是
壁灯	壁灯是安装在室内墙壁上的辅助照明装饰灯具，一般多配用乳白色的玻璃灯罩。灯泡功率多在15-40瓦左右，光线淡雅和谐，可把环境点缀得优雅、富丽，尤以新婚居室特别适合。壁灯的种类和样式较多，一般常见的吸顶灯、变色壁灯、床头壁灯、镜前壁灯等。
温馨	温馨是一个汉语词汇，拼音是wēn xīn，意思是温暖，馨香，客气，体贴。出自唐 韩愈 《芍药歌》：“温馨熟美鲜香起，似笑无言习君子。”
四川	四川，简称“川”或“蜀”，是中华人民共和国省级行政区。省会成都，位于中国西南地区内陆，界于北纬26°03′-34°19′，东经97°21′-108°12′之间，东连重庆，南邻云南、贵州，西接西藏，北界陕西、甘肃、青海，四川省总面积48.6万平方千米。四川省地貌东西差异大，地形复杂多样，位于中国大陆地势三大阶梯中的第一级青藏高原和第二级长江中下游平原的过渡地带，高差悬殊，地势呈西高东低的特点，由山地、丘陵、平原盆地和高原构成。四川省分属三大气候，分别为四川盆地中亚热带湿润气候，川西南山地亚热带半湿润气候，川西北高山高原高寒气候，总体气候宜人，拥有众多长寿之乡，如都江堰市、彭山县、长宁县等90岁以上人口均超过千人。截至2018年底，四川省下辖18个省辖市，3个自治州，17个县级市，108个县，4个自治县，54个市辖区。2018年，四川
手环	手环是人类发展历史上的一种配饰，在不同时期不同场合对于不同的人物具有不同的意义。市场上有各式各样材质的手环，已成为一种时尚元素。手环制造材料五花八门，有塑料的、金属的、树枝的、花束的、水晶的等等。
调味	调味就是把菜肴的主、副料与多种调味品适当配合，使其相互影响，经过一系列复杂的理化变化，去其异味、增加美味，形成各种不同风味菜肴的过程。调味是菜肴制作的关键技术之一，只有不断地操练和摸索，才能慢慢地掌握其规律与方法，并与火候巧妙地结合，烹制出色、香、形、味俱好的佳肴。调味的常用方法有：1．因料调味；2．因菜调味；3．因时调味；4．因人调味；5．因地调味。
成品	[End product] 做好了的可供使用或出售的企业在报告期内生产的，经检验合格并已包装入库的产品，或虽未入库，但已办理入库手续的产品。
枕套	枕套（pillow case）就是在枕巾下面、包裹枕芯的东西，像一个布口袋。枕套是现代枕头的一个重要组成部分，古代人是不用枕套的，他们使用枕芯加上枕巾(pillow cover)组成。
瑞士	瑞士联邦（德语：Schweizerische Eidgenossenschaft，法语：Confédération suisse，意大利语：Confederazione Svizzera，罗曼什语：Confederaziun svizra），简称“瑞士”（英语：Switzerland），是中欧国家之一，全国划分为26个州。瑞士北邻德国，西邻法国，南邻意大利，东邻奥地利和列支敦士登。全境以高原和山地为主，有“欧洲屋脊”之称。伯尔尼是联邦政府的所在地。瑞士历史上曾有雇佣兵制度，后来才改采武装中立。11世纪受神圣罗马帝国统治。1291年8月1日，
01	《01》是歌手孔令奇发行2002年4月18日专辑名称，共收录13首歌曲。
胡桃木	胡桃木，是木材中较优质的一种，主要产自北美和欧洲、东南亚。国产的胡桃木，颜色较浅。黑胡桃呈浅黑褐色带紫色，弦切面为美丽的大抛物线花纹。胡桃木用来做家具不仅成型效果好，而且表面光泽饱和色彩丰富且饱满。
鱼缸	鱼缸，一种装活鱼的水缸，缸体透明，多为玻璃质地，也可用来饲养热带鱼或者金鱼起到观赏的作用。鱼缸不仅是鱼儿的家，更是家人共同的生活享受。无瑕的双层浮化玻璃，既给鱼儿营造了一个温馨的家，也保证了整体居室环境的安全。鱼缸更是家居风水里必不可少的摆件，是与空间的完美结合，是家居、办公，商业空间的灵魂禅师。
耐高温	百度百科是一部内容开放、自由的网络百科全书，旨在创造一个涵盖所有领域知识，服务所有互联网用户的中文知识性百科全书。在这里你可以参与词条编辑，分享贡献你的
网面	百度百科是一部内容开放、自由的网络百科全书，旨在创造一个涵盖所有领域知识，服务所有互联网用户的中文知识性百科全书。在这里你可以参与词条编辑，分享贡献你的
柔软	《柔软》内容简介：历时十一年的“悲观主义三部曲”首度集结，三个剧本，记录了编剧内心情感世界的变迁，抛开世俗，直指爱情本质。《柔软》：“悲观主义三部曲”的完结篇。讲述了一个性别错乱的年轻人，在变性的过程中，与绯闻缠身的女医生产生了难以名状的情感，还有界定不清的性关系。它刺穿了世俗，直抵爱情与灵魂的本质。
花花公子	花花公子是花花公子企业国际有限公司的品牌，英文名：Playboy Enterprises International, Inc。公司创立于1953年，主要从事娱乐产业，旗下包括化妆品，箱包，杂志，传媒等各个领域。
沙发椅	沙发椅通常指单人沙发，品种包括皮制、布艺、金属、藤制以及实木等。
纸巾	纸巾（英文：Paper towel；Facial tissue），是日常生活用品，纸巾成分有氯、漂白粉、酒精、木浆及可再生资源。纸巾种类多种多样。
抓绒	抓绒，是一种布料。特点是保暖、防风、轻量，具有易压缩、易打理、抗静电性能。
纸尿裤	纸尿裤的核心关键技术是“芯体”。从技术层面来说，纸尿裤芯体至今共经历了三次革命。纸尿裤是一次性使用后即可抛弃的产品。以无纺布、卫生纸、绒毛浆、高分子吸水树脂、PE膜、橡皮筋等材料制成。有幼儿专用与成人专用两种。最新研发的环保可降解的纸尿裤，以玉米纤维、大豆纤维或荞麦纤维提炼的原材料制造。
灯饰	灯饰——家居的眼睛，家庭中如果没有灯具，就像人没有了眼睛，没有眼睛的家庭只能生活在黑暗中，所以灯 在家庭的位置是至关重要的。如今人们将照明的灯具都叫作灯饰，从称谓上就可以看出，灯具已不仅仅是用来照明的了，它还可以用来装饰房间。
房间	《房间》是由兰纳德·阿伯拉罕森执导，布丽·拉尔森、雅各布·特瑞布雷、威廉姆·H·梅西等主演的剧情片。该片于2016年1月15日在爱尔兰上映。该片改编自爱玛·多诺霍的同名原著小说，讲述了一个女孩被邻居所骗，之后被囚禁在一个狭小的房间里长达七年之久的故事。
线衣	线衣是由各种服用纤维组成的纱线，通过手工或者针织机械织成的服装。
40	夏马尔，动漫家庭教师里的人物，喜欢泡妞的世界一流的黑市医生。俗称为“三叉戟夏马尔”。意大利名车中的“二王一后”-法拉利、兰博基尼为王，后就是夏马尔的代表车玛莎拉蒂-maserati了。并且玛莎拉蒂的车标就是三叉戟，故名字由来。
奶嘴	奶嘴，是使用在奶瓶上帮助吸奶的一种工具，多为婴儿使用。
反季	《反季》，网络小说，作者方镜，连载于晋江文学城。
播放器	通常指的播放器是指能播放以数字信号形式存储的视频或音频文件的软件，也指具有播放视频或音频文件功能的电子器件产品。如基于闪存的mp3播放器和基于移动硬盘的iPod等。除了少数波形文件外，大多数播放器携带解码器以还原经过压缩媒体文件，播放器还要内置一整套转换频率以及缓冲的算法。以前是播放音频和视频的软件各具特色，现在大多则是视频音频播放器合二为一了。
925	百度百科是一部内容开放、自由的网络百科全书，旨在创造一个涵盖所有领域知识，服务所有互联网用户的中文知识性百科全书。在这里你可以参与词条编辑，分享贡献你的
不规则	不规则：汉语词汇不规则：郭小霖演唱歌曲不规则：黎明所唱歌曲
铝合金	铝合金是工业中应用最广泛的一类有色金属结构材料，在航空、航天、汽车、机械制造、船舶及化学工业中已大量应用。工业经济的飞速发展，对铝合金焊接结构件的需求日益增多，使铝合金的焊接性研究也随之深入。目前铝合金是应用最多的合金。
小包装	百度百科是一部内容开放、自由的网络百科全书，旨在创造一个涵盖所有领域知识，服务所有互联网用户的中文知识性百科全书。在这里你可以参与词条编辑，分享贡献你的
旅游	“旅”是旅行，外出，即为了实现某一目的而在空间上从甲地到乙地的行进过程；“游”是外出游览、观光、娱乐，即为达到这些目的所作的旅行。二者合起来即旅游。所以，旅行偏重于行，旅游不但有“行”，且有观光、娱乐含义。中央纪委国家监委网站的相关统计数据显示，“中秋国庆期间违反中央八项规定精神问题监督举报曝光专区”近三年中通报了989起案例。其中，数量排名第五位的是公款国内旅游，109起。
短筒	百度百科是一部内容开放、自由的网络百科全书，旨在创造一个涵盖所有领域知识，服务所有互联网用户的中文知识性百科全书。在这里你可以参与词条编辑，分享贡献你的
16	16（十六），是15与17之间的自然数。16是4的平方。
白酒	白酒（外文名：Liquor and Spirits），是中国酒类（除了果酒、米酒外）的统称，又称烧酒、老白干、烧刀子等。中国白酒具有以酯类为主体的复合香味，以曲类、酒母为糖化发酵剂，利用淀粉质（糖质）原料，经蒸煮、糖化、发酵、蒸馏、陈酿和勾兑而酿制而成的各类酒。而严格意义上讲，由食用酒精和食用香料勾兑而成的配制酒则不能算做是白酒。白酒主集中在长江上游和赤水河流域的贵州仁怀、四川宜宾、四川泸州三角地带有着全球规模最大、质量最优的蒸馏酒产区，分别为中国三大名酒的茅五泸，其白酒产业集群扛起中国白酒产业的半壁河山。
重低音	重低音其实是电子音乐里，低音音乐的一个叫法。所谓的重低音就是比较重的低音，概念重低音就是提升音频中的低音部分(100HZ以下，甚至包括次声波.人虽然听不见，但还是有效果的).因为人耳对低音是不敏感的，所以需要较强的低音来产生效果。
阔腿裤	阔腿裤（loose pants）是一款拥有宽阔裤脚的裤子，从大腿处至裤脚上下一样的宽度。宽松的轮廓，让你看起来更加的简洁大气。阔腿裤更是问题身材MM的救星，帮你修饰不完美的腿型，贴身的款式又能束腰收腹，让整体装扮十分显瘦。
免烫	百度百科是一部内容开放、自由的网络百科全书，旨在创造一个涵盖所有领域知识，服务所有互联网用户的中文知识性百科全书。在这里你可以参与词条编辑，分享贡献你的
布洛克	桑德拉·布洛克，1964年7月26日出生于美国弗吉尼亚州阿灵顿，演员、制片人。1987年，出演个人首部电影《占领美国》，从而进入演艺圈。1992年，其出演的爱情片《第九号爱情香水》上映。1994年，主演的动作片《生死时速》全球累计票房为3.5亿美元。1996年，凭借爱情片《二见钟情》提名第53届美国金球奖音乐喜剧类最佳女主角。2000年，在喜剧片《特工佳丽》中饰演格雷西·哈特。2002年，主演爱情片《贴身情人》。2005年，留名好莱坞星光大道。2009年，担任喜剧片《假结婚》的制作人。2010年，凭借主演的剧情片《弱点》获得第82届奥斯卡金像奖最佳女主角、第67届美国金球奖剧情类最佳女主角；同年，获得第19届MTV电影奖MTV世代奖。2013年，出演科幻片《地心引力》。2018年，主演惊悚片《蒙上你的眼》。
骆驼	骆驼被称为“沙漠之舟”的哺乳动物。头较小，颈粗长，弯曲如鹅颈。躯体高大，体毛褐色。极能忍饥耐渴。骆驼可以在没有水的条件下生存2周，没有食物可生存一个月之久。驼峰里贮存着脂肪，可在得不到食物时，分解成身体所需养分，供骆驼生存需要。另外，骆驼的胃里有许多瓶子形状的小泡泡，用来贮存水。骆驼可用作骑乘、驮运、拉车、犁地等，是沙漠戈壁地区人民和地质勘探、考古工作者不可缺少的伙伴。单峰驼主要分布于苏丹，索马里，印度等国；双峰驼近一半分布于澳大利亚，中国主要分布于新疆、甘肃、内蒙。
全手工	百度百科是一部内容开放、自由的网络百科全书，旨在创造一个涵盖所有领域知识，服务所有互联网用户的中文知识性百科全书。在这里你可以参与词条编辑，分享贡献你的
慵懒	慵懒是一个汉语词语，读音为yōng lǎn，意思是困倦；懒惰；懒散；懒洋洋的样子。出自白居易 《池上早春即事招梦得》。
秋裤	秋裤是指气温比较冷时候穿在毛裤、棉裤或外裤里面用来保暖用的长裤。一般在秋天天气转凉时，穿一条单裤不够保暖，就在裤子里面再添加一条贴身的裤子，所以就叫秋裤，为北方词汇。在淮河以南地区叫作棉毛裤，有些地方又叫衬裤，线裤。秋裤属于内衣类，不能外穿出门。且保暖程度仅次于保暖裤，可以有效的防寒。
牛津布	牛津布又称牛津纺，是一种功能多样、用途广泛的面料，市场上主要有：套格、全弹、锦纶、提格等品种。起源于英国，以牛津大学命名的传统精梳棉织物，始于1900年左右。
黑胡桃	黑胡桃（Juglans Nigra.），又名黑核桃，生长良好的胡桃木平均高度20-30m，直径1m-1.5m，密度约0.560.67 g/cm3。黑胡桃木心边材区分明显，边材浅黄褐色至浅栗褐色，心材红褐色至栗褐色，有时带紫色，间有深色条纹，久露空气呈现巧克力色，生长轮明显，半散孔材，侵填体常见，木射线细，放大镜下明显，轴向薄壁组织放大镜下明显，径切面上有射线斑纹，波痕未见。
adidas	adidas（阿迪达斯）创办于1949年，是德国运动用品制造商阿迪达斯AG成员公司。以其创办人阿道夫·阿迪·达斯勒（Adolf Adi Dassler）命名，1920年在黑措根奥拉赫开始生产鞋类产品。1949年8月18日以adidas AG名字登记。阿迪达斯原本由两兄弟共同开设，在分道扬镳后，阿道夫的哥哥鲁道夫·达斯勒 （Rudolf Dassler）开设了运动品牌puma。其经典广告语：“没有不可能”（Nothing is impossible）。2011年3月，斥资1.6亿欧元启用全新口号——adidas is all in（全倾全力）。2017年6月，adidas入选《麻省理工科技评论》2017 年度全球50 大最聪明公司”榜单。2018年7月19日，2018年《财富》世界500强排行榜发布，adidas位列480位。2018年12月，世界品牌实验室编制的《2018世界品牌500强》
恒温	恒温，是在一定的环境下保持不变的温度，需要精密的仪器来随时测定温度的变化，然后调节温度，使之始终是一个温度。
